hour_beginning	pedestrians	to_manhattan	to_brooklyn	weather_summary	temperature	precipitation	events
10/1/2017 0:00	44	30	14	clear-night	52	0.0001	
10/1/2017 1:00	30	17	13	partly-cloudy-night	53	0.0002	
10/1/2017 2:00	25	13	12	partly-cloudy-night	52	0	
10/1/2017 3:00	20	11	9	partly-cloudy-night	51	0	
10/1/2017 4:00	18	10	8	partly-cloudy-night	51	0	
10/1/2017 5:00	16	12	4	partly-cloudy-night	50	0	
10/1/2017 6:00	113	88	25	partly-cloudy-night	49	0.0001	
10/1/2017 7:00	199	72	127	clear-day	49	0	
10/1/2017 8:00	261	133	128	clear-day	50	0	
10/1/2017 9:00	845	504	341	clear-day	54	0	
10/1/2017 10:00	2478	1906	572	clear-day	57	0	
10/1/2017 11:00	3006	1277	1729	clear-day	60	0	
10/1/2017 12:00	2263	1233	1030	clear-day	62	0	
10/1/2017 13:00	2616	1447	1169	clear-day	64	0	
10/1/2017 14:00	2463	1339	1124	clear-day	65	0	
10/1/2017 15:00	2245	1189	1056	clear-day	66	0	
10/1/2017 16:00	2764	1040	1724	clear-day	67	0	
10/1/2017 17:00	2247	1140	1107	clear-day	67	0	
10/1/2017 18:00	2142	1091	1051	clear-day	66	0	
10/1/2017 19:00	899	298	601	clear-night	62	0	
10/1/2017 20:00	481	143	338	clear-night	59	0	
10/1/2017 21:00	275	117	158	clear-night	57	0	
10/1/2017 22:00	133	53	80	clear-night	55	0	
10/1/2017 23:00	104	68	36	clear-night	54	0	
10/2/2017 0:00	60	20	40	clear-night	53	0	
10/2/2017 1:00	27	15	12	clear-night	52	0	
10/2/2017 2:00	6	3	3	clear-night	51	0	
10/2/2017 3:00	8	5	3	clear-night	50	0	
10/2/2017 4:00	2	0	2	clear-night	49	0	
10/2/2017 5:00	19	13	6	clear-night	48	0	
10/2/2017 6:00	96	64	32	clear-night	49	0	
10/2/2017 7:00	182	81	101	clear-day	48	0	
10/2/2017 8:00	362	138	224	clear-day	50	0	
10/2/2017 9:00	536	293	243	clear-day	56	0	
10/2/2017 10:00	1071	645	426	clear-day	60	0	
10/2/2017 11:00	1617	860	757	clear-day	64	0	
10/2/2017 12:00	1756	829	927	clear-day	66	0	
10/2/2017 13:00	1753	898	855	clear-day	68	0	
10/2/2017 14:00	1719	885	834	clear-day	69	0	
10/2/2017 15:00	1637	867	770	clear-day	71	0	
10/2/2017 16:00	1883	1044	839	clear-day	71	0	
10/2/2017 17:00	1952	1072	880	clear-day	71	0	
10/2/2017 18:00	1659	1055	604	clear-day	69	0	
10/2/2017 19:00	773	319	454	clear-night	65	0	
10/2/2017 20:00	376	171	205	clear-night	62	0	
10/2/2017 21:00	301	142	159	clear-night	60	0	
10/2/2017 22:00	155	79	76	clear-night	58	0	
10/2/2017 23:00	78	46	32	clear-night	57	0	
10/3/2017 0:00	45	26	19	clear-night	55	0	
10/3/2017 1:00	17	12	5	clear-night	53	0	
10/3/2017 2:00	7	2	5	clear-night	52	0	
10/3/2017 3:00	5	2	3	clear-night	51	0	
10/3/2017 4:00	8	3	5	clear-night	51	0	
10/3/2017 5:00	22	14	8	clear-night	50	0	
10/3/2017 6:00	122	76	46	clear-night	50	0	
10/3/2017 7:00	230	96	134	clear-day	50	0	
10/3/2017 8:00	390	162	228	clear-day	52	0	
10/3/2017 9:00	616	341	275	clear-day	59	0	
10/3/2017 10:00	936	555	381	clear-day	62	0.0002	
10/3/2017 11:00	1517	799	718	clear-day	65	0.0003	
10/3/2017 12:00	1666	852	814	clear-day	67	0.0002	
10/3/2017 13:00	1572	792	780	partly-cloudy-day	67	0	
10/3/2017 14:00	1642	762	880	clear-day	68	0.0001	
10/3/2017 15:00	1686	901	785	clear-day	68	0	
10/3/2017 16:00	1572	824	748	clear-day	67	0	
10/3/2017 17:00	1695	996	699	clear-day	66	0	
10/3/2017 18:00	1478	893	585	clear-day	64	0	
10/3/2017 19:00	613	240	373	clear-night	61	0	
10/3/2017 20:00	341	160	181	clear-night	59	0	
10/3/2017 21:00	196	102	94	clear-night	58	0	
10/3/2017 22:00	134	65	69	clear-night	56	0	
10/3/2017 23:00	70	34	36	clear-night	55	0	
10/4/2017 0:00	28	14	14	clear-night	55	0	
10/4/2017 1:00	16	11	5	clear-night	53	0	
10/4/2017 2:00	11	7	4	clear-night	53	0	
10/4/2017 3:00	12	5	7	clear-night	52	0	
10/4/2017 4:00	11	6	5	clear-night	51	0	
10/4/2017 5:00	16	9	7	clear-night	51	0	
10/4/2017 6:00	106	68	38	clear-night	51	0	
10/4/2017 7:00	291	125	166	clear-night	50	0	
10/4/2017 8:00	412	159	253	clear-day	52	0	
10/4/2017 9:00	571	299	272	clear-day	57	0	
10/4/2017 10:00	1017	621	396	clear-day	62	0	
10/4/2017 11:00	1530	830	700	clear-day	65	0	
10/4/2017 12:00	1709	899	810	clear-day	68	0	
10/4/2017 13:00	1611	811	800	clear-day	71	0	
10/4/2017 14:00	1608	794	814	clear-day	73	0	
10/4/2017 15:00	1524	874	650	clear-day	74	0	
10/4/2017 16:00	1733	964	769	clear-day	74	0	
10/4/2017 17:00	1907	1135	772	clear-day	74	0	
10/4/2017 18:00	1739	1081	658	clear-day	72	0	
10/4/2017 19:00	737	278	459	clear-night	70	0	
10/4/2017 20:00	395	150	245	clear-night	69	0	
10/4/2017 21:00	264	135	129	clear-night	68	0	
10/4/2017 22:00	181	85	96	clear-night	68	0.0001	
10/4/2017 23:00	104	57	47	partly-cloudy-night	67	0.0001	
10/5/2017 0:00	41	15	26	clear-night	65	0	
10/5/2017 1:00	21	10	11	clear-night	64	0	
10/5/2017 2:00	3	3	0	partly-cloudy-night	64	0	
10/5/2017 3:00	3	0	3	partly-cloudy-night	64	0	
10/5/2017 4:00	2	1	1	partly-cloudy-night	64	0	
10/5/2017 5:00	19	12	7	partly-cloudy-night	63	0	
10/5/2017 6:00	101	54	47	partly-cloudy-night	63	0	
10/5/2017 7:00	307	133	174	partly-cloudy-night	63	0	
10/5/2017 8:00	338	126	212	partly-cloudy-day	63	0	
10/5/2017 9:00	687	392	295	clear-day	65	0	
10/5/2017 10:00	1081	640	441	clear-day	69	0.0009	
10/5/2017 11:00	1644	923	721	clear-day	73	0.0019	
10/5/2017 12:00	1705	817	888	rain	77	0.0272	
10/5/2017 13:00	1726	850	876	clear-day	79	0.0024	
10/5/2017 14:00	1812	908	904	partly-cloudy-day	80	0.0021	
10/5/2017 15:00	1829	983	846	partly-cloudy-day	81	0.0012	
10/5/2017 16:00	1835	910	925	clear-day	81	0	
10/5/2017 17:00	1956	1129	827	clear-day	80	0	
10/5/2017 18:00	1382	787	595	partly-cloudy-day	78	0	
10/5/2017 19:00	635	250	385	clear-night	77	0	
10/5/2017 20:00	393	180	213	partly-cloudy-night	76	0	
10/5/2017 21:00	287	125	162	clear-night	75	0	
10/5/2017 22:00	115	54	61	partly-cloudy-night	74	0.0007	
10/5/2017 23:00	58	16	42	partly-cloudy-night	71	0.001	
10/6/2017 0:00	50	21	29	partly-cloudy-night	70	0.0011	
10/6/2017 1:00	22	11	11	partly-cloudy-night	69	0.0017	
10/6/2017 2:00	8	3	5	partly-cloudy-night	69	0.0021	
10/6/2017 3:00	15	8	7	clear-night	68	0.0012	
10/6/2017 4:00	7	3	4	clear-night	67	0.0002	
10/6/2017 5:00	16	11	5	partly-cloudy-night	67	0	
10/6/2017 6:00	126	74	52	clear-night	66	0	
10/6/2017 7:00	279	120	159	partly-cloudy-night	66	0	
10/6/2017 8:00	493	242	251	clear-day	66	0	
10/6/2017 9:00	660	386	274	clear-day	68	0	
10/6/2017 10:00	1244	686	558	clear-day	70	0	
10/6/2017 11:00	1593	893	700	clear-day	74	0	
10/6/2017 12:00	1941	1049	892	clear-day	76	0	
10/6/2017 13:00	1862	906	956	clear-day	78	0	
10/6/2017 14:00	1989	941	1048	clear-day	80	0	
10/6/2017 15:00	2140	1136	1004	clear-day	80	0	
10/6/2017 16:00	2083	1122	961	clear-day	78	0	
10/6/2017 17:00	2124	1188	936	clear-day	77	0	
10/6/2017 18:00	1470	834	636	clear-day	74	0	
10/6/2017 19:00	759	275	484	clear-night	71	0	
10/6/2017 20:00	471	184	287	clear-night	70	0	
10/6/2017 21:00	364	152	212	clear-night	69	0	
10/6/2017 22:00	238	100	138	clear-night	69	0	
10/6/2017 23:00	135	69	66	clear-night	69	0	
10/7/2017 0:00	88	52	36	clear-night	69	0	
10/7/2017 1:00	64	32	32	clear-night	68	0	
10/7/2017 2:00	29	17	12	clear-night	68	0	
10/7/2017 3:00	10	5	5	clear-night	66	0	
10/7/2017 4:00	9	6	3	partly-cloudy-night	66	0	
10/7/2017 5:00	21	13	8	partly-cloudy-night	65	0	
10/7/2017 6:00	84	55	29	partly-cloudy-night	65	0	
10/7/2017 7:00	244	109	135	partly-cloudy-night	64	0	
10/7/2017 8:00	378	225	153	partly-cloudy-day	65	0	
10/7/2017 9:00	989	655	334	partly-cloudy-day	68	0	
10/7/2017 10:00	1737	1037	700	clear-day	70	0	
10/7/2017 11:00	2602	1510	1092	clear-day	74	0	
10/7/2017 12:00	2983	1591	1392	clear-day	77	0	
10/7/2017 13:00	3191	1691	1500	clear-day	78	0	
10/7/2017 14:00	3251	1765	1486	clear-day	79	0	
10/7/2017 15:00	3633	1834	1799	clear-day	78	0	
10/7/2017 16:00	3388	1644	1744	clear-day	77	0	
10/7/2017 17:00	3373	1796	1577	clear-day	76	0	
10/7/2017 18:00	2742	1325	1417	clear-day	75	0	
10/7/2017 19:00	1132	373	759	clear-night	73	0	
10/7/2017 20:00	665	213	452	clear-night	72	0	
10/7/2017 21:00	373	150	223	clear-night	71	0	
10/7/2017 22:00	356	145	211	clear-night	71	0	
10/7/2017 23:00	268	119	149	partly-cloudy-night	71	0	
10/8/2017 0:00	145	75	70	partly-cloudy-night	71	0	
10/8/2017 1:00	57	38	19	clear-night	71	0	
10/8/2017 2:00	46	25	21	partly-cloudy-night	72	0	
10/8/2017 3:00	11	6	5	partly-cloudy-night	72	0	
10/8/2017 4:00	26	19	7	partly-cloudy-night	72	0	
10/8/2017 5:00	24	15	9	partly-cloudy-night	72	0	
10/8/2017 6:00	41	24	17	partly-cloudy-night	72	0.0004	
10/8/2017 7:00	160	90	70	partly-cloudy-night	72	0.0014	
10/8/2017 8:00	216	86	130	partly-cloudy-day	72	0.0016	
10/8/2017 9:00	164	91	73	partly-cloudy-day	72	0.0013	
10/8/2017 10:00	479	247	232	partly-cloudy-day	72	0.001	
10/8/2017 11:00	882	335	547	partly-cloudy-day	72	0.0009	
10/8/2017 12:00	1504	762	742	partly-cloudy-day	73	0.0008	
10/8/2017 13:00	1923	1027	896	partly-cloudy-day	74	0.0007	
10/8/2017 14:00	2599	1280	1319	partly-cloudy-day	75	0	
10/8/2017 15:00	2606	1376	1230	partly-cloudy-day	76	0	
10/8/2017 16:00	2531	1224	1307	partly-cloudy-day	76	0	
10/8/2017 17:00	2485	1241	1244	clear-day	76	0	
10/8/2017 18:00	1745	858	887	partly-cloudy-day	76	0	
10/8/2017 19:00	783	233	550	clear-night	75	0	
10/8/2017 20:00	589	224	365	partly-cloudy-night	75	0	
10/8/2017 21:00	453	171	282	clear-night	74	0	
10/8/2017 22:00	311	129	182	clear-night	74	0.0008	
10/8/2017 23:00	213	93	120	clear-night	73	0.0014	
10/9/2017 0:00	112	38	74	clear-night	73	0.0014	Columbus Day (regional holiday)
10/9/2017 1:00	41	15	26	partly-cloudy-night	73	0.001	Columbus Day (regional holiday)
10/9/2017 2:00	22	17	5	partly-cloudy-night	72	0.0008	Columbus Day (regional holiday)
10/9/2017 3:00	7	2	5	clear-night	72	0.0007	Columbus Day (regional holiday)
10/9/2017 4:00	6	3	3	partly-cloudy-night	72	0.0008	Columbus Day (regional holiday)
10/9/2017 5:00	9	5	4	partly-cloudy-night	72	0.0009	Columbus Day (regional holiday)
10/9/2017 6:00	58	45	13	partly-cloudy-night	71	0.0006	Columbus Day (regional holiday)
10/9/2017 7:00	169	81	88	partly-cloudy-night	71	0.0001	Columbus Day (regional holiday)
10/9/2017 8:00	296	130	166	partly-cloudy-day	71	0	Columbus Day (regional holiday)
10/9/2017 9:00	477	254	223	partly-cloudy-day	72	0	Columbus Day (regional holiday)
10/9/2017 10:00	888	446	442	partly-cloudy-day	72	0.0001	Columbus Day (regional holiday)
10/9/2017 11:00	825	375	450	partly-cloudy-day	72	0.0003	Columbus Day (regional holiday)
10/9/2017 12:00	732	300	432	partly-cloudy-day	73	0.0017	Columbus Day (regional holiday)
10/9/2017 13:00	422	192	230	rain	73	0.0058	Columbus Day (regional holiday)
10/9/2017 14:00	654	339	315	rain	72	0.0056	Columbus Day (regional holiday)
10/9/2017 15:00	787	414	373	partly-cloudy-day	72	0.0044	Columbus Day (regional holiday)
10/9/2017 16:00	881	480	401	partly-cloudy-day	73	0.0016	Columbus Day (regional holiday)
10/9/2017 17:00	878	490	388	partly-cloudy-day	74	0.0004	Columbus Day (regional holiday)
10/9/2017 18:00	722	348	374	partly-cloudy-day	74	0.0003	Columbus Day (regional holiday)
10/9/2017 19:00	368	175	193	partly-cloudy-night	74	0.0004	Columbus Day (regional holiday)
10/9/2017 20:00	250	125	125	partly-cloudy-night	74	0.0005	Columbus Day (regional holiday)
10/9/2017 21:00	184	91	93	partly-cloudy-night	74	0.0005	Columbus Day (regional holiday)
10/9/2017 22:00	117	42	75	partly-cloudy-night	74	0.0005	Columbus Day (regional holiday)
10/9/2017 23:00	80	42	38	partly-cloudy-night	75	0.0007	Columbus Day (regional holiday)
10/10/2017 0:00	29	12	17	partly-cloudy-night	74	0.0006	
10/10/2017 1:00	13	7	6	partly-cloudy-night	73	0.0004	
10/10/2017 2:00	14	9	5	partly-cloudy-night	71	0	
10/10/2017 3:00	16	6	10	clear-night	70	0	
10/10/2017 4:00	8	6	2	clear-night	68	0	
10/10/2017 5:00	24	16	8	clear-night	67	0	
10/10/2017 6:00	131	76	55	clear-night	66	0	
10/10/2017 7:00	296	141	155	clear-night	65	0	
10/10/2017 8:00	490	190	300	clear-day	66	0	
10/10/2017 9:00	683	401	282	clear-day	68	0	
10/10/2017 10:00	1499	896	603	clear-day	71	0	
10/10/2017 11:00	2037	1087	950	clear-day	74	0	
10/10/2017 12:00	2088	1024	1064	clear-day	76	0	
10/10/2017 13:00	2105	1007	1098	clear-day	77	0	
10/10/2017 14:00	2323	1146	1177	clear-day	78	0	
10/10/2017 15:00	1907	1016	891	clear-day	79	0	
10/10/2017 16:00	1960	1000	960	clear-day	79	0	
10/10/2017 17:00	1913	1162	751	clear-day	79	0	
10/10/2017 18:00	1535	933	602	clear-day	78	0	
10/10/2017 19:00	776	248	528	clear-night	74	0	
10/10/2017 20:00	448	189	259	clear-night	72	0	
10/10/2017 21:00	308	141	167	clear-night	70	0	
10/10/2017 22:00	141	65	76	clear-night	68	0	
10/10/2017 23:00	77	30	47	clear-night	67	0	
10/11/2017 0:00	40	17	23	clear-night	66	0	
10/11/2017 1:00	24	11	13	clear-night	65	0	
10/11/2017 2:00	9	3	6	clear-night	64	0	
10/11/2017 3:00	8	6	2	clear-night	63	0	
10/11/2017 4:00	8	8	0	clear-night	63	0	
10/11/2017 5:00	37	24	13	clear-night	63	0	
10/11/2017 6:00	100	60	40	clear-night	63	0	
10/11/2017 7:00	277	142	135	clear-night	64	0	
10/11/2017 8:00	437	149	288	clear-day	64	0	
10/11/2017 9:00	535	244	291	clear-day	65	0	
10/11/2017 10:00	1116	694	422	clear-day	67	0	
10/11/2017 11:00	1602	843	759	clear-day	69	0	
10/11/2017 12:00	1576	758	818	clear-day	71	0	
10/11/2017 13:00	1572	770	802	clear-day	72	0	
10/11/2017 14:00	1808	861	947	clear-day	73	0	
10/11/2017 15:00	1657	855	802	partly-cloudy-day	73	0	
10/11/2017 16:00	1744	944	800	partly-cloudy-day	72	0	
10/11/2017 17:00	1713	820	893	partly-cloudy-day	70	0	
10/11/2017 18:00	615	371	244	partly-cloudy-day	69	0	
10/11/2017 19:00	288	113	175	partly-cloudy-night	67	0	
10/11/2017 20:00	242	122	120	partly-cloudy-night	66	0	
10/11/2017 21:00	143	80	63	partly-cloudy-night	65	0	
10/11/2017 22:00	139	69	70	partly-cloudy-night	65	0	
10/11/2017 23:00	65	34	31	partly-cloudy-night	64	0	
10/12/2017 0:00	27	10	17	partly-cloudy-night	64	0	
10/12/2017 1:00	15	7	8	partly-cloudy-night	63	0.0001	
10/12/2017 2:00	6	3	3	partly-cloudy-night	61	0.0004	
10/12/2017 3:00	0	0	0	partly-cloudy-night	60	0.0013	
10/12/2017 4:00	1	1	0	partly-cloudy-night	60	0.0029	
10/12/2017 5:00	7	6	1	partly-cloudy-night	58	0.004	
10/12/2017 6:00	59	33	26	partly-cloudy-night	58	0.0023	
10/12/2017 7:00	152	85	67	partly-cloudy-night	57	0.0009	
10/12/2017 8:00	278	106	172	partly-cloudy-day	57	0.0002	
10/12/2017 9:00	360	153	207	partly-cloudy-day	57	0	
10/12/2017 10:00	687	436	251	partly-cloudy-day	57	0	
10/12/2017 11:00	1239	762	477	partly-cloudy-day	58	0	
10/12/2017 12:00	1663	842	821	partly-cloudy-day	59	0	
10/12/2017 13:00	1883	943	940	partly-cloudy-day	61	0	
10/12/2017 14:00	1776	900	876	partly-cloudy-day	62	0	
10/12/2017 15:00	1530	786	744	partly-cloudy-day	63	0	
10/12/2017 16:00	1780	957	823	partly-cloudy-day	63	0	
10/12/2017 17:00	1825	1089	736	clear-day	63	0	
10/12/2017 18:00	1437	739	698	clear-day	62	0	
10/12/2017 19:00	606	246	360	clear-night	60	0	
10/12/2017 20:00	332	165	167	clear-night	59	0	
10/12/2017 21:00	211	112	99	partly-cloudy-night	58	0	
10/12/2017 22:00	144	85	59	clear-night	57	0	
10/12/2017 23:00	61	33	28	clear-night	56	0	
10/13/2017 0:00	47	29	18	clear-night	55	0	
10/13/2017 1:00	17	10	7	clear-night	54	0	
10/13/2017 2:00	16	9	7	clear-night	54	0	
10/13/2017 3:00	13	7	6	clear-night	53	0	
10/13/2017 4:00	10	6	4	partly-cloudy-night	52	0	
10/13/2017 5:00	17	11	6	partly-cloudy-night	52	0	
10/13/2017 6:00	92	53	39	partly-cloudy-night	52	0	
10/13/2017 7:00	251	117	134	partly-cloudy-night	52	0	
10/13/2017 8:00	391	142	249	partly-cloudy-day	53	0	
10/13/2017 9:00	500	271	229	partly-cloudy-day	55	0	
10/13/2017 10:00	1145	697	448	partly-cloudy-day	57	0	
10/13/2017 11:00	1931	1102	829	partly-cloudy-day	59	0	
10/13/2017 12:00	2159	1114	1045	partly-cloudy-day	61	0	
10/13/2017 13:00	2016	983	1033	partly-cloudy-day	63	0	
10/13/2017 14:00	2340	1085	1255	partly-cloudy-day	64	0	
10/13/2017 15:00	2276	1159	1117	partly-cloudy-day	64	0	
10/13/2017 16:00	2386	1237	1149	partly-cloudy-day	65	0	
10/13/2017 17:00	2344	1256	1088	partly-cloudy-day	64	0	
10/13/2017 18:00	1574	860	714	partly-cloudy-day	63	0	
10/13/2017 19:00	700	311	389	partly-cloudy-night	63	0	
10/13/2017 20:00	370	157	213	partly-cloudy-night	62	0	
10/13/2017 21:00	356	163	193	partly-cloudy-night	62	0	
10/13/2017 22:00	181	92	89	partly-cloudy-night	62	0	
10/13/2017 23:00	144	57	87	partly-cloudy-night	62	0	
10/14/2017 0:00	65	24	41	partly-cloudy-night	62	0.0002	
10/14/2017 1:00	36	17	19	partly-cloudy-night	62	0.0008	
10/14/2017 2:00	8	5	3	partly-cloudy-night	61	0.0006	
10/14/2017 3:00	7	5	2	partly-cloudy-night	61	0.0009	
10/14/2017 4:00	5	4	1	partly-cloudy-night	61	0.0012	
10/14/2017 5:00	15	12	3	partly-cloudy-night	61	0.0018	
10/14/2017 6:00	37	25	12	partly-cloudy-night	61	0.0018	
10/14/2017 7:00	204	109	95	partly-cloudy-night	61	0.0017	
10/14/2017 8:00	555	372	183	partly-cloudy-day	62	0.0006	
10/14/2017 9:00	1503	1300	203	partly-cloudy-day	62	0.0003	
10/14/2017 10:00	2628	2191	437	cloudy	63	0.0002	
10/14/2017 11:00	2331	1550	781	partly-cloudy-day	65	0.0002	
10/14/2017 12:00	2721	1539	1182	partly-cloudy-day	67	0	
10/14/2017 13:00	3059	1706	1353	partly-cloudy-day	68	0	
10/14/2017 14:00	3047	1418	1629	partly-cloudy-day	70	0	
10/14/2017 15:00	3187	1584	1603	cloudy	70	0	
10/14/2017 16:00	2962	1445	1517	cloudy	71	0	
10/14/2017 17:00	2585	1253	1332	partly-cloudy-day	70	0	
10/14/2017 18:00	1860	880	980	partly-cloudy-day	70	0	
10/14/2017 19:00	818	309	509	partly-cloudy-night	68	0	
10/14/2017 20:00	575	248	327	partly-cloudy-night	68	0	
10/14/2017 21:00	393	162	231	cloudy	67	0	
10/14/2017 22:00	283	143	140	partly-cloudy-night	67	0	
10/14/2017 23:00	218	92	126	partly-cloudy-night	66	0	
10/15/2017 0:00	168	82	86	partly-cloudy-night	66	0	
10/15/2017 1:00	62	36	26	partly-cloudy-night	65	0	
10/15/2017 2:00	42	18	24	partly-cloudy-night	65	0	
10/15/2017 3:00	23	11	12	partly-cloudy-night	65	0	
10/15/2017 4:00	9	6	3	partly-cloudy-night	65	0	
10/15/2017 5:00	14	11	3	partly-cloudy-night	65	0	
10/15/2017 6:00	43	26	17	partly-cloudy-night	64	0	
10/15/2017 7:00	226	122	104	partly-cloudy-night	64	0	
10/15/2017 8:00	399	205	194	partly-cloudy-day	65	0	
10/15/2017 9:00	758	512	246	partly-cloudy-day	65	0	
10/15/2017 10:00	1509	904	605	partly-cloudy-day	66	0	
10/15/2017 11:00	1949	1130	819	partly-cloudy-day	68	0	
10/15/2017 12:00	2420	1356	1064	partly-cloudy-day	69	0	
10/15/2017 13:00	2649	1426	1223	partly-cloudy-day	71	0	
10/15/2017 14:00	3049	1427	1622	partly-cloudy-day	72	0	
10/15/2017 15:00	2904	1390	1514	partly-cloudy-day	72	0	
10/15/2017 16:00	2824	1280	1544	partly-cloudy-day	71	0	
10/15/2017 17:00	2298	1033	1265	cloudy	71	0	
10/15/2017 18:00	1330	555	775	cloudy	69	0	
10/15/2017 19:00	636	249	387	cloudy	69	0	
10/15/2017 20:00	474	195	279	cloudy	68	0	
10/15/2017 21:00	335	145	190	cloudy	68	0	
10/15/2017 22:00	196	87	109	partly-cloudy-night	68	0	
10/15/2017 23:00	107	53	54	partly-cloudy-night	68	0	
10/16/2017 0:00	60	25	35	partly-cloudy-night	68	0	
10/16/2017 1:00	11	3	8	partly-cloudy-night	68	0	
10/16/2017 2:00	10	6	4	partly-cloudy-night	68	0	
10/16/2017 3:00	1	1	0	partly-cloudy-night	66	0	
10/16/2017 4:00	3	2	1	partly-cloudy-night	64	0	
10/16/2017 5:00	18	12	6	partly-cloudy-night	61	0	
10/16/2017 6:00	58	34	24	partly-cloudy-night	61	0	
10/16/2017 7:00	221	99	122	partly-cloudy-night	60	0	
10/16/2017 8:00	425	156	269	clear-day	58	0	
10/16/2017 9:00	537	248	289	clear-day	56	0	
10/16/2017 10:00	1002	573	429	clear-day	55	0	
10/16/2017 11:00	1489	808	681	clear-day	56	0	
10/16/2017 12:00	1667	880	787	clear-day	56	0	
10/16/2017 13:00	2001	941	1060	clear-day	56	0	
10/16/2017 14:00	1836	947	889	clear-day	56	0	
10/16/2017 15:00	2096	1046	1050	clear-day	57	0	
10/16/2017 16:00	1723	889	834	clear-day	57	0	
10/16/2017 17:00	1712	998	714	clear-day	56	0	
10/16/2017 18:00	1095	583	512	clear-day	55	0	
10/16/2017 19:00	429	171	258	clear-night	54	0	
10/16/2017 20:00	225	97	128	clear-night	53	0	
10/16/2017 21:00	133	59	74	clear-night	51	0	
10/16/2017 22:00	84	40	44	clear-night	50	0	
10/16/2017 23:00	46	22	24	clear-night	48	0	
10/17/2017 0:00	31	16	15	clear-night	47	0	
10/17/2017 1:00	7	3	4	clear-night	46	0	
10/17/2017 2:00	5	3	2	clear-night	44	0	
10/17/2017 3:00	3	2	1	clear-night	43	0	
10/17/2017 4:00	2	0	2	clear-night	42	0	
10/17/2017 5:00	10	6	4	clear-night	42	0	
10/17/2017 6:00	81	45	36	clear-night	40	0	
10/17/2017 7:00	233	91	142	clear-night	40	0	
10/17/2017 8:00	291	91	200	clear-day	41	0	
10/17/2017 9:00	480	252	228	clear-day	45	0	
10/17/2017 10:00	1119	720	399	clear-day	47	0	
10/17/2017 11:00	1454	757	697	clear-day	50	0	
10/17/2017 12:00	1668	863	805	clear-day	52	0	
10/17/2017 13:00	1543	786	757	clear-day	54	0	
10/17/2017 14:00	1388	709	679	clear-day	57	0	
10/17/2017 15:00	1309	721	588	clear-day	58	0	
10/17/2017 16:00	1495	833	662	clear-day	59	0	
10/17/2017 17:00	1641	983	658	clear-day	59	0	
10/17/2017 18:00	1189	679	510	clear-day	57	0	
10/17/2017 19:00	490	197	293	clear-night	54	0	
10/17/2017 20:00	236	113	123	clear-night	52	0	
10/17/2017 21:00	147	74	73	clear-night	52	0	
10/17/2017 22:00	88	52	36	clear-night	51	0	
10/17/2017 23:00	46	27	19	clear-night	51	0	
10/18/2017 0:00	23	11	12	clear-night	49	0	
10/18/2017 1:00	14	11	3	clear-night	49	0	
10/18/2017 2:00	4	3	1	clear-night	48	0	
10/18/2017 3:00	5	3	2	clear-night	48	0	
10/18/2017 4:00	5	4	1	clear-night	48	0	
10/18/2017 5:00	24	17	7	clear-night	47	0	
10/18/2017 6:00	91	51	40	clear-night	47	0	
10/18/2017 7:00	283	128	155	clear-night	47	0	
10/18/2017 8:00	358	123	235	clear-day	47	0	
10/18/2017 9:00	523	270	253	clear-day	51	0	
10/18/2017 10:00	1050	681	369	clear-day	55	0	
10/18/2017 11:00	1522	916	606	clear-day	60	0	
10/18/2017 12:00	1652	936	716	clear-day	65	0	
10/18/2017 13:00	1580	816	764	clear-day	68	0	
10/18/2017 14:00	1580	788	792	clear-day	70	0	
10/18/2017 15:00	1477	764	713	clear-day	72	0	
10/18/2017 16:00	1861	1062	799	clear-day	72	0	
10/18/2017 17:00	1789	1005	784	clear-day	71	0	
10/18/2017 18:00	1141	586	555	clear-day	67	0	
10/18/2017 19:00	536	195	341	clear-night	64	0	
10/18/2017 20:00	353	184	169	clear-night	62	0	
10/18/2017 21:00	223	112	111	clear-night	60	0	
10/18/2017 22:00	153	83	70	clear-night	59	0	
10/18/2017 23:00	83	44	39	clear-night	58	0	
10/19/2017 0:00	34	10	24	clear-night	60	0	
10/19/2017 1:00	18	9	9	clear-night	59	0	
10/19/2017 2:00	5	2	3	clear-night	58	0	
10/19/2017 3:00	7	4	3	clear-night	57	0	
10/19/2017 4:00	3	2	1	clear-night	55	0	
10/19/2017 5:00	29	16	13	clear-night	55	0	
10/19/2017 6:00	111	63	48	clear-night	53	0	
10/19/2017 7:00	304	144	160	clear-night	53	0	
10/19/2017 8:00	402	129	273	clear-day	55	0	
10/19/2017 9:00	584	303	281	clear-day	58	0	
10/19/2017 10:00	1479	910	569	clear-day	60	0	
10/19/2017 11:00	1738	931	807	clear-day	63	0	
10/19/2017 12:00	1747	857	890	clear-day	66	0	
10/19/2017 13:00	2062	981	1081	clear-day	68	0	
10/19/2017 14:00	2021	1010	1011	clear-day	69	0	
10/19/2017 15:00	1976	1025	951	clear-day	70	0	
10/19/2017 16:00	1923	953	970	clear-day	70	0	
10/19/2017 17:00	2101	1227	874	clear-day	69	0	
10/19/2017 18:00	1324	601	723	clear-day	68	0	
10/19/2017 19:00	582	245	337	clear-night	66	0	
10/19/2017 20:00	353	176	177	clear-night	65	0	
10/19/2017 21:00	264	134	130	clear-night	64	0	
10/19/2017 22:00	150	68	82	clear-night	63	0	
10/19/2017 23:00	103	58	45	clear-night	62	0	
10/20/2017 0:00	30	14	16	clear-night	59	0	
10/20/2017 1:00	23	12	11	clear-night	59	0	
10/20/2017 2:00	10	8	2	clear-night	58	0	
10/20/2017 3:00	5	4	1	clear-night	57	0	
10/20/2017 4:00	6	2	4	clear-night	57	0	
10/20/2017 5:00	26	13	13	clear-night	55	0	
10/20/2017 6:00	135	79	56	clear-night	55	0	
10/20/2017 7:00	277	140	137	clear-night	54	0	
10/20/2017 8:00	360	143	217	clear-day	56	0	
10/20/2017 9:00	665	351	314	clear-day	60	0	
10/20/2017 10:00	1412	892	520	clear-day	63	0	
10/20/2017 11:00	1994	1023	971	clear-day	66	0	
10/20/2017 12:00	2098	1012	1086	clear-day	69	0	
10/20/2017 13:00	2245	1176	1069	clear-day	71	0	
10/20/2017 14:00	2102	1066	1036	clear-day	72	0	
10/20/2017 15:00	2140	1102	1038	clear-day	73	0	
10/20/2017 16:00	2213	1207	1006	clear-day	73	0	
10/20/2017 17:00	2290	1374	916	clear-day	72	0	
10/20/2017 18:00	1409	731	678	clear-day	70	0	
10/20/2017 19:00	567	218	349	clear-night	67	0	
10/20/2017 20:00	361	160	201	clear-night	65	0	
10/20/2017 21:00	279	145	134	clear-night	63	0	
10/20/2017 22:00	201	96	105	clear-night	61	0	
10/20/2017 23:00	180	73	107	clear-night	60	0	
10/21/2017 0:00	84	48	36	clear-night	59	0	
10/21/2017 1:00	29	16	13	clear-night	57	0	
10/21/2017 2:00	19	9	10	clear-night	55	0	
10/21/2017 3:00	16	8	8	clear-night	53	0	
10/21/2017 4:00	14	9	5	clear-night	53	0	
10/21/2017 5:00	21	16	5	clear-night	53	0	
10/21/2017 6:00	87	58	29	clear-night	52	0	
10/21/2017 7:00	287	147	140	clear-night	52	0	
10/21/2017 8:00	382	189	193	clear-day	53	0	
10/21/2017 9:00	945	568	377	clear-day	58	0	
10/21/2017 10:00	1639	1008	631	clear-day	63	0	
10/21/2017 11:00	2464	1519	945	clear-day	67	0	
10/21/2017 12:00	3022	1533	1489	clear-day	72	0	
10/21/2017 13:00	3209	1666	1543	clear-day	76	0	
10/21/2017 14:00	3587	1899	1688	clear-day	77	0	
10/21/2017 15:00	3600	1858	1742	clear-day	77	0	
10/21/2017 16:00	3558	1763	1795	clear-day	75	0	
10/21/2017 17:00	3609	1805	1804	clear-day	73	0	
10/21/2017 18:00	1828	793	1035	clear-day	69	0	
10/21/2017 19:00	849	325	524	clear-night	66	0	
10/21/2017 20:00	514	245	269	clear-night	61	0	
10/21/2017 21:00	406	170	236	clear-night	61	0	
10/21/2017 22:00	244	111	133	clear-night	61	0	
10/21/2017 23:00	201	115	86	clear-night	60	0	
10/22/2017 0:00	147	85	62	clear-night	58	0	
10/22/2017 1:00	74	29	45	clear-night	57	0	
10/22/2017 2:00	20	15	5	clear-night	57	0	
10/22/2017 3:00	25	16	9	clear-night	56	0	
10/22/2017 4:00	2	1	1	clear-night	55	0	
10/22/2017 5:00	13	8	5	clear-night	55	0	
10/22/2017 6:00	57	40	17	clear-night	54	0	
10/22/2017 7:00	213	133	80	clear-night	54	0	
10/22/2017 8:00	387	214	173	clear-day	54	0	
10/22/2017 9:00	999	630	369	clear-day	56	0	
10/22/2017 10:00	2355	1392	963	clear-day	59	0	
10/22/2017 11:00	2679	1516	1163	clear-day	62	0	
10/22/2017 12:00	2907	1560	1347	clear-day	63	0	
10/22/2017 13:00	3229	1724	1505	clear-day	65	0	
10/22/2017 14:00	3093	1510	1583	clear-day	65	0	
10/22/2017 15:00	3046	1596	1450	clear-day	65	0	
10/22/2017 16:00	3066	1457	1609	clear-day	64	0	
10/22/2017 17:00	2763	1378	1385	clear-day	64	0	
10/22/2017 18:00	1536	566	970	clear-day	62	0	
10/22/2017 19:00	739	249	490	clear-night	61	0	
10/22/2017 20:00	402	183	219	clear-night	60	0	
10/22/2017 21:00	278	106	172	clear-night	59	0	
10/22/2017 22:00	148	75	73	clear-night	58	0	
10/22/2017 23:00	105	54	51	clear-night	58	0	
10/23/2017 0:00	49	23	26	clear-night	58	0	
10/23/2017 1:00	16	9	7	clear-night	57	0	
10/23/2017 2:00	19	10	9	clear-night	57	0	
10/23/2017 3:00	7	5	2	partly-cloudy-night	58	0	
10/23/2017 4:00	5	3	2	partly-cloudy-night	59	0	
10/23/2017 5:00	24	14	10	partly-cloudy-night	59	0	
10/23/2017 6:00	83	44	39	partly-cloudy-night	60	0	
10/23/2017 7:00	340	153	187	partly-cloudy-night	60	0	
10/23/2017 8:00	542	201	341	partly-cloudy-day	61	0	
10/23/2017 9:00	766	366	400	partly-cloudy-day	63	0	
10/23/2017 10:00	1224	684	540	partly-cloudy-day	66	0	
10/23/2017 11:00	2125	1104	1021	partly-cloudy-day	70	0	
10/23/2017 12:00	2357	1128	1229	partly-cloudy-day	72	0	
10/23/2017 13:00	2137	1085	1052	clear-day	72	0	
10/23/2017 14:00	2280	1199	1081	partly-cloudy-day	72	0	
10/23/2017 15:00	2391	1187	1204	partly-cloudy-day	71	0	
10/23/2017 16:00	2530	1314	1216	clear-day	71	0	
10/23/2017 17:00	2191	1203	988	partly-cloudy-day	69	0	
10/23/2017 18:00	1075	573	502	partly-cloudy-day	68	0	
10/23/2017 19:00	539	238	301	partly-cloudy-night	68	0	
10/23/2017 20:00	321	181	140	partly-cloudy-night	68	0	
10/23/2017 21:00	216	105	111	partly-cloudy-night	68	0	
10/23/2017 22:00	127	58	69	clear-night	69	0	
10/23/2017 23:00	78	45	33	partly-cloudy-night	68	0	
10/24/2017 0:00	47	24	23	partly-cloudy-night	68	0	
10/24/2017 1:00	16	6	10	partly-cloudy-night	68	0	
10/24/2017 2:00	10	9	1	partly-cloudy-night	68	0	
10/24/2017 3:00	5	2	3	partly-cloudy-night	68	0	
10/24/2017 4:00	4	1	3	partly-cloudy-night	68	0	
10/24/2017 5:00	32	24	8	partly-cloudy-night	69	0	
10/24/2017 6:00	115	62	53	partly-cloudy-night	69	0	
10/24/2017 7:00	274	125	149	partly-cloudy-night	70	0	
10/24/2017 8:00	507	236	271	partly-cloudy-day	69	0	
10/24/2017 9:00	677	378	299	partly-cloudy-day	69	0	
10/24/2017 10:00	1265	674	591	partly-cloudy-day	70	0	
10/24/2017 11:00	1978	994	984	partly-cloudy-day	72	0	
10/24/2017 12:00	1975	785	1190	partly-cloudy-day	73	0	
10/24/2017 13:00	1413	419	994	partly-cloudy-day	71	0	
10/24/2017 14:00	1217	636	581	partly-cloudy-day	70	0	
10/24/2017 15:00	1659	762	897	partly-cloudy-day	70	0	
10/24/2017 16:00	1773	1016	757	partly-cloudy-day	69	0	
10/24/2017 17:00	1237	816	421	partly-cloudy-day	68	0	
10/24/2017 18:00	1396	820	576	partly-cloudy-night	68	0	
10/24/2017 19:00	931	499	432	partly-cloudy-night	68	0	
10/24/2017 20:00	708	424	284	partly-cloudy-night	67	0	
10/24/2017 21:00	153	85	68	partly-cloudy-night	67	0	
10/24/2017 22:00	121	57	64	partly-cloudy-night	67	0	
10/24/2017 23:00	50	14	36	partly-cloudy-night	66	0	
10/25/2017 0:00	23	11	12	partly-cloudy-night	66	0.0019	
10/25/2017 1:00	16	9	7	partly-cloudy-night	65	0.008	
10/25/2017 2:00	10	5	5	partly-cloudy-night	64	0.0007	
10/25/2017 3:00	10	5	5	clear-night	63	0.0006	
10/25/2017 4:00	4	2	2	clear-night	62	0.0004	
10/25/2017 5:00	23	15	8	partly-cloudy-night	60	0.0002	
10/25/2017 6:00	104	66	38	clear-night	59	0.0004	
10/25/2017 7:00	324	170	154	clear-night	57	0.0001	
10/25/2017 8:00	513	181	332	clear-day	56	0.0008	
10/25/2017 9:00	797	367	430	clear-day	57	0.0009	
10/25/2017 10:00	1437	782	655	clear-day	58	0.0002	
10/25/2017 11:00	1987	982	1005	partly-cloudy-day	60	0.0002	
10/25/2017 12:00	2131	1025	1106	partly-cloudy-day	61	0.0013	
10/25/2017 13:00	1971	994	977	partly-cloudy-day	62	0.0024	
10/25/2017 14:00	2277	1149	1128	partly-cloudy-day	64	0	
10/25/2017 15:00	2217	1121	1096	partly-cloudy-day	64	0.0015	
10/25/2017 16:00	2241	1201	1040	partly-cloudy-day	64	0.0008	
10/25/2017 17:00	2271	1355	916	partly-cloudy-day	63	0.0013	
10/25/2017 18:00	1136	557	579	partly-cloudy-night	62	0.0008	
10/25/2017 19:00	455	245	210	partly-cloudy-night	61	0.0008	
10/25/2017 20:00	319	137	182	partly-cloudy-night	60	0	
10/25/2017 21:00	188	90	98	clear-night	59	0.0012	
10/25/2017 22:00	158	96	62	clear-night	59	0	
10/25/2017 23:00	103	46	57	partly-cloudy-night	58	0.0001	
10/26/2017 0:00	42	18	24	partly-cloudy-night	57	0	
10/26/2017 1:00	14	10	4	partly-cloudy-night	56	0	
10/26/2017 2:00	4	2	2	partly-cloudy-night	55	0	
10/26/2017 3:00	5	3	2	partly-cloudy-night	55	0	
10/26/2017 4:00	0	0	0	partly-cloudy-night	54	0	
10/26/2017 5:00	22	12	10	partly-cloudy-night	54	0	
10/26/2017 6:00	76	50	26	partly-cloudy-night	53	0	
10/26/2017 7:00	341	231	110	clear-night	52	0	
10/26/2017 8:00	508	208	300	partly-cloudy-day	52	0	
10/26/2017 9:00	661	338	323	partly-cloudy-day	53	0	
10/26/2017 10:00	1258	716	542	partly-cloudy-day	54	0	
10/26/2017 11:00	1795	937	858	partly-cloudy-day	55	0.0004	
10/26/2017 12:00	1871	911	960	partly-cloudy-day	55	0.0015	
10/26/2017 13:00	1661	699	962	partly-cloudy-day	55	0.0014	
10/26/2017 14:00	1791	814	977	partly-cloudy-day	55	0.0009	
10/26/2017 15:00	1520	757	763	partly-cloudy-day	56	0.0004	
10/26/2017 16:00	1483	764	719	partly-cloudy-day	55	0.0024	
10/26/2017 17:00	1447	777	670	partly-cloudy-day	55	0.0033	
10/26/2017 18:00	756	379	377	partly-cloudy-night	55	0.0003	
10/26/2017 19:00	357	179	178	clear-night	55	0	
10/26/2017 20:00	212	102	110	clear-night	53	0	
10/26/2017 21:00	159	88	71	clear-night	52	0.0001	
10/26/2017 22:00	109	69	40	clear-night	51	0	
10/26/2017 23:00	64	38	26	clear-night	50	0	
10/27/2017 0:00	26	15	11	clear-night	48	0.0001	
10/27/2017 1:00	17	11	6	clear-night	47	0	
10/27/2017 2:00	5	5	0	clear-night	46	0	
10/27/2017 3:00	13	8	5	clear-night	46	0	
10/27/2017 4:00	4	3	1	clear-night	42	0.0001	
10/27/2017 5:00	22	13	9	clear-night	45	0	
10/27/2017 6:00	91	54	37	clear-night	44	0	
10/27/2017 7:00	260	122	138	clear-night	44	0	
10/27/2017 8:00	347	145	202	clear-day	44	0	
10/27/2017 9:00	670	380	290	clear-day	47	0.0009	
10/27/2017 10:00	1650	994	656	clear-day	51	0	
10/27/2017 11:00	2150	1126	1024	clear-day	55	0	
10/27/2017 12:00	2603	1268	1335	clear-day	58	0	
10/27/2017 13:00	2753	1372	1381	clear-day	60	0	
10/27/2017 14:00	2743	1429	1314	clear-day	61	0.0006	
10/27/2017 15:00	2679	1281	1398	clear-day	62	0.0008	
10/27/2017 16:00	2571	1285	1286	clear-day	62	0	
10/27/2017 17:00	2672	1468	1204	clear-day	61	0.0004	
10/27/2017 18:00	1457	621	836	clear-night	59	0.0015	
10/27/2017 19:00	570	198	372	clear-night	56	0	
10/27/2017 20:00	326	155	171	clear-night	55	0	
10/27/2017 21:00	225	99	126	clear-night	54	0	
10/27/2017 22:00	193	89	104	clear-night	53	0	
10/27/2017 23:00	139	76	63	clear-night	52	0	
10/28/2017 0:00	78	36	42	clear-night	52	0	
10/28/2017 1:00	23	14	9	clear-night	51	0	
10/28/2017 2:00	14	8	6	clear-night	50	0	
10/28/2017 3:00	3	0	3	clear-night	49	0	
10/28/2017 4:00	6	4	2	clear-night	48	0	
10/28/2017 5:00	12	7	5	clear-night	48	0	
10/28/2017 6:00	49	37	12	clear-night	48	0	
10/28/2017 7:00	272	148	124	clear-night	48	0	
10/28/2017 8:00	371	192	179	clear-day	49	0	
10/28/2017 9:00	951	575	376	clear-day	53	0	
10/28/2017 10:00	2962	2267	695	clear-day	59	0	
10/28/2017 11:00	4330	2150	2180	clear-day	64	0.0001	
10/28/2017 12:00	3486	1925	1561	clear-day	66	0.0017	
10/28/2017 13:00	4055	1560	2495	clear-day	67	0.0028	
10/28/2017 14:00	3816	1865	1951	clear-day	68	0.0002	
10/28/2017 15:00	3852	1927	1925	clear-day	68	0.0013	
10/28/2017 16:00	3750	1758	1992	clear-day	66	0	
10/28/2017 17:00	3451	1587	1864	clear-day	65	0.0021	
10/28/2017 18:00	1534	589	945	clear-night	64	0	
10/28/2017 19:00	645	278	367	clear-night	63	0	
10/28/2017 20:00	518	236	282	partly-cloudy-night	63	0	
10/28/2017 21:00	393	187	206	partly-cloudy-night	62	0	
10/28/2017 22:00	254	124	130	partly-cloudy-night	61	0	
10/28/2017 23:00	152	78	74	partly-cloudy-night	62	0	
10/29/2017 0:00	92	57	35	partly-cloudy-night	62	0	
10/29/2017 1:00	56	28	28	partly-cloudy-night	62	0	
10/29/2017 2:00	25	11	14	partly-cloudy-night	63	0	
10/29/2017 3:00	2	1	1	partly-cloudy-night	63	0.0008	
10/29/2017 4:00	5	5	0	partly-cloudy-night	62	0.0039	
10/29/2017 5:00	1	0	1	partly-cloudy-night	60	0.0061	
10/29/2017 6:00	6	4	2	partly-cloudy-night	60	0.011	
10/29/2017 7:00	75	52	23	partly-cloudy-night	61	0.0134	
10/29/2017 8:00	162	67	95	partly-cloudy-day	61	0.0094	
10/29/2017 9:00	283	148	135	partly-cloudy-day	61	0.0066	
10/29/2017 10:00	598	340	258	rain	61	0.0293	
10/29/2017 11:00	640	302	338	partly-cloudy-day	61	0.0163	
10/29/2017 12:00	520	240	280	rain	62	0.0249	
10/29/2017 13:00	292	126	166	rain	62	0.0628	
10/29/2017 14:00	186	67	119	rain	63	0.1802	
10/29/2017 15:00	82	37	45	rain	64	0.2382	
10/29/2017 16:00	110	70	40	rain	64	0.2926	
10/29/2017 17:00	76	39	37	rain	64	0.3305	
10/29/2017 18:00	37	24	13	rain	64	0.1515	
10/29/2017 19:00	16	8	8	rain	64	0.1252	
10/29/2017 20:00	9	5	4	rain	64	0.1249	
10/29/2017 21:00	2	1	1	rain	63	0.1711	
10/29/2017 22:00	2	1	1	rain	63	0.2921	
10/29/2017 23:00	4	3	1	rain	65	0.2357	
10/30/2017 0:00	11	8	3	rain	61	0.0734	
10/30/2017 1:00	3	2	1	clear-night	59	0.0157	
10/30/2017 2:00	10	2	8	partly-cloudy-night	58	0.0013	
10/30/2017 3:00	6	3	3	partly-cloudy-night	57	0.0004	
10/30/2017 4:00	0	0	0	partly-cloudy-night	56	0.0023	
10/30/2017 5:00	5	4	1	rain	54	0.0342	
10/30/2017 6:00	18	10	8	rain	51	0.0396	
10/30/2017 7:00	47	21	26	rain	48	0.0296	
10/30/2017 8:00	126	47	79	rain	46	0.0364	
10/30/2017 9:00	324	187	137	partly-cloudy-day	47	0.0233	
10/30/2017 10:00	911	581	330	partly-cloudy-day	49	0.0042	
10/30/2017 11:00	1730	921	809	partly-cloudy-day	51	0.0005	
10/30/2017 12:00	1940	955	985	partly-cloudy-day	53	0.0005	
10/30/2017 13:00	1914	960	954	partly-cloudy-day	55	0.0009	
10/30/2017 14:00	2234	1207	1027	partly-cloudy-day	55	0.0001	
10/30/2017 15:00	2274	1222	1052	partly-cloudy-day	55	0.0002	
10/30/2017 16:00	2068	1064	1004	partly-cloudy-day	55	0.0002	
10/30/2017 17:00	2066	1112	954	clear-day	55	0.0007	
10/30/2017 18:00	1084	491	593	clear-night	53	0.0001	
10/30/2017 19:00	409	178	231	clear-night	52	0.0009	
10/30/2017 20:00	279	130	149	clear-night	51	0.0004	
10/30/2017 21:00	166	75	91	clear-night	51	0	
10/30/2017 22:00	102	51	51	clear-night	51	0	
10/30/2017 23:00	47	22	25	clear-night	50	0.0001	
10/31/2017 0:00	25	7	18	clear-night	51	0	Halloween
10/31/2017 1:00	3	2	1	clear-night	51	0	Halloween
10/31/2017 2:00	6	5	1	clear-night	50	0	Halloween
10/31/2017 3:00	3	3	0	clear-night	49	0	Halloween
10/31/2017 4:00	2	1	1	clear-night	49	0	Halloween
10/31/2017 5:00	24	14	10	clear-night	49	0	Halloween
10/31/2017 6:00	76	42	34	clear-night	48	0	Halloween
10/31/2017 7:00	247	116	131	clear-night	48	0	Halloween
10/31/2017 8:00	350	131	219	clear-day	47	0.0001	Halloween
10/31/2017 9:00	796	411	385	clear-day	49	0	Halloween
10/31/2017 10:00	1667	945	722	clear-day	51	0	Halloween
10/31/2017 11:00	2304	1135	1169	partly-cloudy-day	52	0	Halloween
10/31/2017 12:00	2464	1184	1280	clear-day	54	0	Halloween
10/31/2017 13:00	2465	1197	1268	clear-day	55	0	Halloween
10/31/2017 14:00	2398	1137	1261	clear-day	56	0	Halloween
10/31/2017 15:00	2094	1023	1071	clear-day	56	0	Halloween
10/31/2017 16:00	2079	954	1125	clear-day	56	0.0001	Halloween
10/31/2017 17:00	1731	868	863	clear-day	55	0	Halloween
10/31/2017 18:00	818	356	462	clear-night	54	0	Halloween
10/31/2017 19:00	275	141	134	clear-night	53	0	Halloween
10/31/2017 20:00	179	70	109	clear-night	52	0	Halloween
10/31/2017 21:00	105	53	52	clear-night	50	0	Halloween
10/31/2017 22:00	60	36	24	clear-night	49	0	Halloween
10/31/2017 23:00	50	33	17	clear-night	48	0	Halloween
11/1/2017 0:00	16	6	10	clear-night	46	0.0001	
11/1/2017 1:00	12	6	6	clear-night	45	0	
11/1/2017 2:00	3	2	1	clear-night	45	0	
11/1/2017 3:00	0	0	0	clear-night	44	0	
11/1/2017 4:00	3	1	2	clear-night	44	0	
11/1/2017 5:00	15	10	5	clear-night	44	0	
11/1/2017 6:00	60	36	24	clear-night	44	0	
11/1/2017 7:00	210	111	99	clear-night	45	0	
11/1/2017 8:00	365	122	243	cloudy	46	0	
11/1/2017 9:00	522	254	268	cloudy	48	0	
11/1/2017 10:00	1069	657	412	cloudy	49	0	
11/1/2017 11:00	1484	861	623	partly-cloudy-day	51	0	
11/1/2017 12:00	1499	720	779	cloudy	53	0	
11/1/2017 13:00	1621	744	877	partly-cloudy-day	54	0	
11/1/2017 14:00	1566	767	799	partly-cloudy-day	55	0	
11/1/2017 15:00	1870	931	939	partly-cloudy-day	55	0	
11/1/2017 16:00	1814	894	920	partly-cloudy-day	56	0	
11/1/2017 17:00	1474	780	694	partly-cloudy-day	56	0	
11/1/2017 18:00	834	442	392	partly-cloudy-night	56	0	
11/1/2017 19:00	413	168	245	partly-cloudy-night	56	0	
11/1/2017 20:00	234	123	111	partly-cloudy-night	55	0	
11/1/2017 21:00	160	87	73	clear-night	56	0	
11/1/2017 22:00	108	67	41	partly-cloudy-night	57	0	
11/1/2017 23:00	57	30	27	cloudy	58	0	
11/2/2017 0:00	33	11	22	partly-cloudy-night	58	0	
11/2/2017 1:00	10	4	6	partly-cloudy-night	58	0	
11/2/2017 2:00	6	2	4	cloudy	59	0	
11/2/2017 3:00	2	2	0	cloudy	59	0	
11/2/2017 4:00	6	3	3	partly-cloudy-night	60	0	
11/2/2017 5:00	19	10	9	partly-cloudy-night	60	0	
11/2/2017 6:00	62	38	24	partly-cloudy-night	60	0	
11/2/2017 7:00	297	180	117	clear-night	60	0	
11/2/2017 8:00	477	191	286	partly-cloudy-day	60	0	
11/2/2017 9:00	579	325	254	partly-cloudy-day	60	0	
11/2/2017 10:00	1447	921	526	partly-cloudy-day	61	0	
11/2/2017 11:00	1960	981	979	partly-cloudy-day	63	0	
11/2/2017 12:00	1972	955	1017	clear-day	67	0	
11/2/2017 13:00	2254	1090	1164	clear-day	69	0	
11/2/2017 14:00	2073	991	1082	partly-cloudy-day	70	0	
11/2/2017 15:00	1957	965	992	clear-day	70	0	
11/2/2017 16:00	2329	1199	1130	clear-day	70	0.0001	
11/2/2017 17:00	2334	1338	996	clear-day	69	0.0036	
11/2/2017 18:00	1254	552	702	clear-night	67	0	
11/2/2017 19:00	488	220	268	clear-night	66	0	
11/2/2017 20:00	316	141	175	partly-cloudy-night	66	0	
11/2/2017 21:00	240	139	101	clear-night	65	0	
11/2/2017 22:00	168	82	86	clear-night	64	0	
11/2/2017 23:00	106	60	46	partly-cloudy-night	64	0	
11/3/2017 0:00	35	12	23	clear-night	62	0	
11/3/2017 1:00	18	10	8	clear-night	61	0	
11/3/2017 2:00	13	5	8	partly-cloudy-night	61	0	
11/3/2017 3:00	1	1	0	clear-night	61	0	
11/3/2017 4:00	5	2	3	clear-night	61	0	
11/3/2017 5:00	21	17	4	partly-cloudy-night	61	0	
11/3/2017 6:00	84	47	37	clear-night	60	0	
11/3/2017 7:00	285	146	139	clear-night	60	0	
11/3/2017 8:00	405	168	237	partly-cloudy-day	60	0.0025	
11/3/2017 9:00	666	404	262	clear-day	62	0	
11/3/2017 10:00	1165	684	481	clear-day	64	0	
11/3/2017 11:00	2004	1060	944	clear-day	67	0	
11/3/2017 12:00	2268	1100	1168	clear-day	68	0	
11/3/2017 13:00	2287	1137	1150	clear-day	70	0	
11/3/2017 14:00	2369	1181	1188	partly-cloudy-day	71	0	
11/3/2017 15:00	2384	1245	1139	clear-day	70	0	
11/3/2017 16:00	2454	1263	1191	clear-day	70	0	
11/3/2017 17:00	2281	1232	1049	partly-cloudy-day	72	0	
11/3/2017 18:00	878	372	506	partly-cloudy-night	70	0	
11/3/2017 19:00	488	206	282	partly-cloudy-night	66	0	
11/3/2017 20:00	308	153	155	partly-cloudy-night	61	0	
11/3/2017 21:00	193	99	94	wind	58	0	
11/3/2017 22:00	114	60	54	clear-night	55	0	
11/3/2017 23:00	87	46	41	clear-night	54	0	
11/4/2017 0:00	46	25	21	clear-night	52	0	
11/4/2017 1:00	19	8	11	clear-night	51	0	
11/4/2017 2:00	17	6	11	clear-night	50	0	
11/4/2017 3:00	4	4	0	clear-night	49	0	
11/4/2017 4:00	7	5	2	clear-night	48	0	
11/4/2017 5:00	10	9	1	clear-night	48	0	
11/4/2017 6:00	42	28	14	clear-night	47	0	
11/4/2017 7:00	310	149	161	clear-night	48	0	
11/4/2017 8:00	358	191	167	partly-cloudy-day	47	0	
11/4/2017 9:00	734	453	281	clear-day	49	0	
11/4/2017 10:00	1349	735	614	clear-day	50	0.0001	
11/4/2017 11:00	2295	1235	1060	clear-day	52	0	
11/4/2017 12:00	2792	1508	1284	clear-day	52	0	
11/4/2017 13:00	3130	1525	1605	clear-day	53	0	
11/4/2017 14:00	2991	1529	1462	partly-cloudy-day	54	0	
11/4/2017 15:00	3297	1496	1801	clear-day	55	0	
11/4/2017 16:00	3235	1540	1695	clear-day	56	0	
11/4/2017 17:00	2801	1364	1437	clear-day	54	0	
11/4/2017 18:00	1187	488	699	clear-night	53	0	
11/4/2017 19:00	502	211	291	clear-night	53	0	
11/4/2017 20:00	359	172	187	partly-cloudy-night	52	0	
11/4/2017 21:00	251	123	128	clear-night	52	0	
11/4/2017 22:00	210	98	112	clear-night	52	0	
11/4/2017 23:00	112	61	51	cloudy	53	0	
11/5/2017 0:00	91	49	42	partly-cloudy-night	53	0	Daylight Saving Time ends
11/5/2017 1:00	29	19	10	partly-cloudy-night	52	0.0077	Daylight Saving Time ends
11/5/2017 2:00	5	4	1	partly-cloudy-night	52	0.0036	Daylight Saving Time ends
11/5/2017 3:00	6	6	0	partly-cloudy-night	53	0.0032	Daylight Saving Time ends
11/5/2017 4:00	9	5	4	partly-cloudy-night	53	0.0008	Daylight Saving Time ends
11/5/2017 5:00	15	12	3	partly-cloudy-night	53	0.0002	Daylight Saving Time ends
11/5/2017 6:00	148	125	23	partly-cloudy-night	53	0.0014	Daylight Saving Time ends
11/5/2017 7:00	173	104	69	cloudy	53	0	Daylight Saving Time ends
11/5/2017 8:00	302	162	140	partly-cloudy-day	55	0	Daylight Saving Time ends
11/5/2017 9:00	700	468	232	partly-cloudy-day	55	0	Daylight Saving Time ends
11/5/2017 10:00	970	607	363	cloudy	56	0	Daylight Saving Time ends
11/5/2017 11:00	1203	670	533	partly-cloudy-day	57	0	Daylight Saving Time ends
11/5/2017 12:00	1242	549	693	cloudy	57	0	Daylight Saving Time ends
11/5/2017 13:00	1034	500	534	cloudy	57	0.0001	Daylight Saving Time ends
11/5/2017 14:00	1087	584	503	cloudy	58	0.007	Daylight Saving Time ends
11/5/2017 15:00	861	417	444	cloudy	58	0.0102	Daylight Saving Time ends
11/5/2017 16:00	1022	559	463	cloudy	59	0.0062	Daylight Saving Time ends
11/5/2017 17:00	476	248	228	partly-cloudy-night	58	0.0058	Daylight Saving Time ends
11/5/2017 18:00	297	158	139	cloudy	60	0.0002	Daylight Saving Time ends
11/5/2017 19:00	213	116	97	partly-cloudy-night	59	0	Daylight Saving Time ends
11/5/2017 20:00	164	86	78	partly-cloudy-night	59	0	Daylight Saving Time ends
11/5/2017 21:00	111	57	54	partly-cloudy-night	60	0	Daylight Saving Time ends
11/5/2017 22:00	73	34	39	cloudy	59	0	Daylight Saving Time ends
11/5/2017 23:00	41	21	20	cloudy	59	0	Daylight Saving Time ends
11/6/2017 0:00	33	17	16	partly-cloudy-night	59	0	
11/6/2017 1:00	12	8	4	partly-cloudy-night	59	0	
11/6/2017 2:00	1	1	0	partly-cloudy-night	59	0	
11/6/2017 3:00	6	3	3	partly-cloudy-night	59	0.0001	
11/6/2017 4:00	5	4	1	partly-cloudy-night	60	0.0003	
11/6/2017 5:00	19	10	9	partly-cloudy-night	60	0.0001	
11/6/2017 6:00	92	55	37	partly-cloudy-night	61	0.0001	
11/6/2017 7:00	223	108	115	cloudy	61	0.0002	
11/6/2017 8:00	341	137	204	cloudy	61	0.0002	
11/6/2017 9:00	503	261	242	cloudy	62	0.0001	
11/6/2017 10:00	887	477	410	partly-cloudy-day	62	0.0005	
11/6/2017 11:00	1428	771	657	partly-cloudy-day	63	0.0003	
11/6/2017 12:00	1506	705	801	partly-cloudy-day	63	0.0003	
11/6/2017 13:00	1424	659	765	partly-cloudy-day	64	0.0003	
11/6/2017 14:00	1587	714	873	partly-cloudy-day	65	0.0005	
11/6/2017 15:00	1345	713	632	rain	64	0.0521	
11/6/2017 16:00	1410	730	680	partly-cloudy-day	64	0.0008	
11/6/2017 17:00	713	371	342	clear-night	63	0.0003	
11/6/2017 18:00	450	224	226	clear-night	60	0.0006	
11/6/2017 19:00	312	181	131	clear-night	56	0.0002	
11/6/2017 20:00	206	128	78	clear-night	54	0	
11/6/2017 21:00	100	51	49	partly-cloudy-night	52	0.0001	
11/6/2017 22:00	80	38	42	partly-cloudy-night	50	0	
11/6/2017 23:00	42	18	24	clear-night	48	0	
11/7/2017 0:00	16	9	7	clear-night	46	0	
11/7/2017 1:00	4	2	2	clear-night	45	0	
11/7/2017 2:00	1	0	1	clear-night	44	0	
11/7/2017 3:00	0	0	0	clear-night	43	0	
11/7/2017 4:00	2	1	1	clear-night	42	0	
11/7/2017 5:00	27	14	13	clear-night	41	0	
11/7/2017 6:00	143	80	63	clear-night	41	0	
11/7/2017 7:00	250	106	144	clear-day	41	0	
11/7/2017 8:00	400	164	236	clear-day	43	0	
11/7/2017 9:00	571	316	255	clear-day	45	0	
11/7/2017 10:00	1073	632	441	clear-day	48	0	
11/7/2017 11:00	1373	660	713	partly-cloudy-day	48	0	
11/7/2017 12:00	1499	680	819	partly-cloudy-day	48	0	
11/7/2017 13:00	1546	767	779	partly-cloudy-day	47	0	
11/7/2017 14:00	1580	760	820	partly-cloudy-day	47	0.0005	
11/7/2017 15:00	966	375	591	partly-cloudy-day	47	0	
11/7/2017 16:00	233	75	158	partly-cloudy-day	45	0.0071	
11/7/2017 17:00	23	13	10	rain	41	0.072	
11/7/2017 18:00	26	20	6	rain	41	0.0996	
11/7/2017 19:00	14	12	2	rain	41	0.0996	
11/7/2017 20:00	11	9	2	rain	40	0.0689	
11/7/2017 21:00	6	6	0	rain	40	0.0448	
11/7/2017 22:00	6	4	2	rain	40	0.0426	
11/7/2017 23:00	1	1	0	rain	40	0.0277	
11/8/2017 0:00	1	0	1	partly-cloudy-night	39	0.0181	
11/8/2017 1:00	4	3	1	partly-cloudy-night	39	0.0036	
11/8/2017 2:00	3	2	1	partly-cloudy-night	39	0.0005	
11/8/2017 3:00	3	2	1	partly-cloudy-night	39	0.0002	
11/8/2017 4:00	5	3	2	partly-cloudy-night	39	0.0002	
11/8/2017 5:00	28	17	11	partly-cloudy-night	39	0.0001	
11/8/2017 6:00	121	86	35	partly-cloudy-night	39	0.0001	
11/8/2017 7:00	238	113	125	partly-cloudy-day	39	0.0001	
11/8/2017 8:00	353	123	230	partly-cloudy-day	39	0.0001	
11/8/2017 9:00	545	266	279	partly-cloudy-day	41	0.0001	
11/8/2017 10:00	1046	649	397	partly-cloudy-day	42	0.0001	
11/8/2017 11:00	1319	664	655	partly-cloudy-day	44	0	
11/8/2017 12:00	1473	714	759	partly-cloudy-day	46	0	
11/8/2017 13:00	1485	719	766	partly-cloudy-day	47	0	
11/8/2017 14:00	1415	677	738	partly-cloudy-day	48	0	
11/8/2017 15:00	1363	690	673	partly-cloudy-day	48	0	
11/8/2017 16:00	1230	613	617	partly-cloudy-day	48	0.0001	
11/8/2017 17:00	653	264	389	partly-cloudy-night	47	0.0008	
11/8/2017 18:00	384	204	180	partly-cloudy-night	46	0	
11/8/2017 19:00	228	142	86	partly-cloudy-night	46	0.0003	
11/8/2017 20:00	182	121	61	partly-cloudy-night	45	0	
11/8/2017 21:00	165	99	66	partly-cloudy-night	44	0	
11/8/2017 22:00	86	56	30	clear-night	43	0.0001	
11/8/2017 23:00	87	57	30	clear-night	42	0.0001	
11/9/2017 0:00	29	20	9	clear-night	41	0	
11/9/2017 1:00	5	4	1	clear-night	40	0.0001	
11/9/2017 2:00	4	2	2	clear-night	39	0	
11/9/2017 3:00	2	1	1	clear-night	39	0	
11/9/2017 4:00	0	0	0	clear-night	39	0	
11/9/2017 5:00	19	10	9	clear-night	38	0	
11/9/2017 6:00	113	82	31	clear-night	38	0	
11/9/2017 7:00	227	124	103	partly-cloudy-day	39	0	
11/9/2017 8:00	351	120	231	partly-cloudy-day	40	0.0001	
11/9/2017 9:00	469	251	218	partly-cloudy-day	43	0.0004	
11/9/2017 10:00	1257	828	429	partly-cloudy-day	47	0.0002	
11/9/2017 11:00	1626	826	800	partly-cloudy-day	50	0.0001	
11/9/2017 12:00	1721	801	920	partly-cloudy-day	52	0	
11/9/2017 13:00	1757	898	859	partly-cloudy-day	52	0.0001	
11/9/2017 14:00	1748	810	938	partly-cloudy-day	53	0	
11/9/2017 15:00	1914	929	985	partly-cloudy-day	53	0.0001	
11/9/2017 16:00	1532	774	758	partly-cloudy-day	52	0	
11/9/2017 17:00	734	340	394	partly-cloudy-night	52	0	
11/9/2017 18:00	455	248	207	partly-cloudy-night	51	0.0004	
11/9/2017 19:00	411	0	0	partly-cloudy-night	51	0	
11/9/2017 20:00	344	0	0	partly-cloudy-night	51	0.0001	
11/9/2017 21:00	300	187	113	partly-cloudy-night	51	0.0001	
11/9/2017 22:00	217	146	71	partly-cloudy-night	52	0.0001	
11/9/2017 23:00	161	140	21	partly-cloudy-night	52	0.0001	
11/10/2017 0:00	113	100	13	partly-cloudy-night	51	0.0014	Veterans Day observed
11/10/2017 1:00	16	9	7	partly-cloudy-night	49	0.0021	Veterans Day observed
11/10/2017 2:00	5	4	1	clear-night	48	0.0008	Veterans Day observed
11/10/2017 3:00	4	2	2	clear-night	47	0.0005	Veterans Day observed
11/10/2017 4:00	2	1	1	clear-night	46	0.0002	Veterans Day observed
11/10/2017 5:00	19	12	7	clear-night	44	0.0004	Veterans Day observed
11/10/2017 6:00	71	42	29	partly-cloudy-night	42	0.0003	Veterans Day observed
11/10/2017 7:00	133	65	68	partly-cloudy-day	39	0	Veterans Day observed
11/10/2017 8:00	224	93	131	clear-day	37	0.0001	Veterans Day observed
11/10/2017 9:00	403	227	176	clear-day	37	0	Veterans Day observed
11/10/2017 10:00	823	417	406	clear-day	37	0	Veterans Day observed
11/10/2017 11:00	1103	544	559	clear-day	36	0.0013	Veterans Day observed
11/10/2017 12:00	1213	506	707	clear-day	36	0.0001	Veterans Day observed
11/10/2017 13:00	1113	522	591	clear-day	35	0.0007	Veterans Day observed
11/10/2017 14:00	1269	587	682	clear-day	35	0.0013	Veterans Day observed
11/10/2017 15:00	1190	553	637	clear-day	35	0	Veterans Day observed
11/10/2017 16:00	1046	486	560	clear-day	33	0	Veterans Day observed
11/10/2017 17:00	638	263	375	clear-night	31	0	Veterans Day observed
11/10/2017 18:00	282	134	148	clear-night	29	0	Veterans Day observed
11/10/2017 19:00	109	62	47	clear-night	28	0.0001	Veterans Day observed
11/10/2017 20:00	101	78	23	clear-night	27	0.0001	Veterans Day observed
11/10/2017 21:00	116	70	46	clear-night	26	0.0014	Veterans Day observed
11/10/2017 22:00	56	37	19	clear-night	25	0.0002	Veterans Day observed
11/10/2017 23:00	57	44	13	clear-night	25	0	Veterans Day observed
11/11/2017 0:00	35	25	10	clear-night	25	0	Veterans Day
11/11/2017 1:00	13	7	6	clear-night	24	0	Veterans Day
11/11/2017 2:00	8	3	5	clear-night	24	0	Veterans Day
11/11/2017 3:00	6	4	2	clear-night	24	0	Veterans Day
11/11/2017 4:00	1	0	1	clear-night	24	0	Veterans Day
11/11/2017 5:00	2	1	1	clear-night	24	0	Veterans Day
11/11/2017 6:00	27	14	13	clear-night	24	0	Veterans Day
11/11/2017 7:00	71	37	34	clear-day	24	0	Veterans Day
11/11/2017 8:00	199	102	97	clear-day	26	0	Veterans Day
11/11/2017 9:00	551	322	229	clear-day	28	0	Veterans Day
11/11/2017 10:00	953	494	459	clear-day	30	0.0006	Veterans Day
11/11/2017 11:00	1459	771	688	clear-day	33	0.0006	Veterans Day
11/11/2017 12:00	1716	771	945	clear-day	35	0.0004	Veterans Day
11/11/2017 13:00	2065	878	1187	clear-day	36	0.0004	Veterans Day
11/11/2017 14:00	2209	987	1222	clear-day	37	0.0004	Veterans Day
11/11/2017 15:00	2265	1027	1238	clear-day	37	0.0003	Veterans Day
11/11/2017 16:00	2233	1036	1197	clear-day	36	0.0001	Veterans Day
11/11/2017 17:00	1077	450	627	clear-night	35	0.0001	Veterans Day
11/11/2017 18:00	659	329	330	clear-night	34	0.0002	Veterans Day
11/11/2017 19:00	413	245	168	clear-night	33	0.0001	Veterans Day
11/11/2017 20:00	226	113	113	clear-night	32	0.0002	Veterans Day
11/11/2017 21:00	156	74	82	clear-night	32	0.0002	Veterans Day
11/11/2017 22:00	141	67	74	clear-night	31	0	Veterans Day
11/11/2017 23:00	162	133	29	clear-night	31	0	Veterans Day
11/12/2017 0:00	96	73	23	clear-night	30	0	
11/12/2017 1:00	8	5	3	clear-night	29	0	
11/12/2017 2:00	8	5	3	clear-night	29	0	
11/12/2017 3:00	8	4	4	clear-night	29	0	
11/12/2017 4:00	7	4	3	clear-night	28	0	
11/12/2017 5:00	11	6	5	clear-night	28	0	
11/12/2017 6:00	38	23	15	clear-night	30	0	
11/12/2017 7:00	103	47	56	clear-day	30	0	
11/12/2017 8:00	234	128	106	clear-day	31	0.0004	
11/12/2017 9:00	521	320	201	clear-day	35	0	
11/12/2017 10:00	1160	649	511	clear-day	38	0.0003	
11/12/2017 11:00	3716	2316	1400	partly-cloudy-day	40	0.0009	
11/12/2017 12:00	1973	905	1068	partly-cloudy-day	42	0.0013	
11/12/2017 13:00	1926	809	1117	clear-day	45	0.002	
11/12/2017 14:00	2022	802	1220	clear-day	46	0.0012	
11/12/2017 15:00	2375	1058	1317	clear-day	46	0.0008	
11/12/2017 16:00	2085	786	1299	clear-day	45	0.0009	
11/12/2017 17:00	1145	452	693	clear-night	43	0.0002	
11/12/2017 18:00	586	263	323	clear-night	41	0.0003	
11/12/2017 19:00	380	203	177	clear-night	40	0.0001	
11/12/2017 20:00	243	144	99	clear-night	39	0.0001	
11/12/2017 21:00	119	52	67	clear-night	38	0.0001	
11/12/2017 22:00	108	50	58	clear-night	38	0	
11/12/2017 23:00	43	14	29	clear-night	39	0.0002	
11/13/2017 0:00	29	15	14	clear-night	39	0.0001	
11/13/2017 1:00	14	9	5	clear-night	39	0	
11/13/2017 2:00	1	1	0	clear-night	40	0.0001	
11/13/2017 3:00	7	1	6	partly-cloudy-night	40	0.0001	
11/13/2017 4:00	9	5	4	partly-cloudy-night	41	0.0001	
11/13/2017 5:00	17	9	8	partly-cloudy-night	41	0.0001	
11/13/2017 6:00	53	21	32	partly-cloudy-night	42	0.0001	
11/13/2017 7:00	79	33	46	partly-cloudy-day	42	0.0002	
11/13/2017 8:00	120	51	69	partly-cloudy-day	42	0.0083	
11/13/2017 9:00	197	104	93	partly-cloudy-day	41	0.0146	
11/13/2017 10:00	280	145	135	partly-cloudy-day	41	0.0114	
11/13/2017 11:00	489	262	227	partly-cloudy-day	42	0.0114	
11/13/2017 12:00	696	367	329	partly-cloudy-day	43	0.006	
11/13/2017 13:00	827	408	419	partly-cloudy-day	45	0.0008	
11/13/2017 14:00	936	394	542	partly-cloudy-day	46	0.0006	
11/13/2017 15:00	983	467	516	partly-cloudy-day	47	0.0003	
11/13/2017 16:00	976	472	504	partly-cloudy-day	45	0.0003	
11/13/2017 17:00	753	371	382	partly-cloudy-night	44	0.0002	
11/13/2017 18:00	463	299	164	partly-cloudy-night	42	0.0002	
11/13/2017 19:00	322	220	102	clear-night	41	0	
11/13/2017 20:00	219	153	66	clear-night	40	0	
11/13/2017 21:00	115	59	56	clear-night	38	0.0002	
11/13/2017 22:00	59	32	27	clear-night	36	0.0003	
11/13/2017 23:00	53	28	25	clear-night	35	0.0002	
11/14/2017 0:00	16	9	7	clear-night	35	0	
11/14/2017 1:00	7	2	5	clear-night	35	0	
11/14/2017 2:00	1	0	1	clear-night	34	0	
11/14/2017 3:00	7	3	4	clear-night	34	0.0001	
11/14/2017 4:00	0	0	0	clear-night	33	0.0001	
11/14/2017 5:00	21	13	8	clear-night	33	0.0002	
11/14/2017 6:00	91	42	49	partly-cloudy-night	34	0.0003	
11/14/2017 7:00	169	74	95	clear-day	34	0.0002	
11/14/2017 8:00	283	90	193	partly-cloudy-day	36	0.0001	
11/14/2017 9:00	408	197	211	partly-cloudy-day	38	0	
11/14/2017 10:00	667	385	282	partly-cloudy-day	41	0	
11/14/2017 11:00	1022	414	608	partly-cloudy-day	42	0	
11/14/2017 12:00	1079	462	617	partly-cloudy-day	43	0.0002	
11/14/2017 13:00	1321	609	712	partly-cloudy-day	46	0.0001	
11/14/2017 14:00	1127	523	604	partly-cloudy-day	46	0.0001	
11/14/2017 15:00	1255	627	628	partly-cloudy-day	46	0.0001	
11/14/2017 16:00	1116	518	598	cloudy	44	0.0002	
11/14/2017 17:00	840	449	391	partly-cloudy-night	43	0.0001	
11/14/2017 18:00	540	345	195	partly-cloudy-night	42	0	
11/14/2017 19:00	369	259	110	partly-cloudy-night	42	0.0002	
11/14/2017 20:00	316	233	83	partly-cloudy-night	41	0.0002	
11/14/2017 21:00	204	142	62	partly-cloudy-night	39	0.0002	
11/14/2017 22:00	138	94	44	partly-cloudy-night	38	0.0002	
11/14/2017 23:00	68	24	44	partly-cloudy-night	37	0.0002	
11/15/2017 0:00	27	13	14	partly-cloudy-night	37	0.0002	
11/15/2017 1:00	7	2	5	partly-cloudy-night	37	0.0002	
11/15/2017 2:00	9	5	4	partly-cloudy-night	36	0.0002	
11/15/2017 3:00	4	2	2	partly-cloudy-night	36	0.0002	
11/15/2017 4:00	4	2	2	partly-cloudy-night	35	0.0002	
11/15/2017 5:00	30	16	14	partly-cloudy-night	34	0.0001	
11/15/2017 6:00	93	51	42	partly-cloudy-night	36	0.0002	
11/15/2017 7:00	176	70	106	clear-day	36	0.0002	
11/15/2017 8:00	297	98	199	clear-day	38	0.0001	
11/15/2017 9:00	396	191	205	clear-day	40	0	
11/15/2017 10:00	693	383	310	clear-day	43	0	
11/15/2017 11:00	1050	494	556	clear-day	45	0	
11/15/2017 12:00	1085	472	613	clear-day	46	0	
11/15/2017 13:00	1112	508	604	clear-day	49	0.0001	
11/15/2017 14:00	1106	526	580	partly-cloudy-day	48	0	
11/15/2017 15:00	1193	553	640	partly-cloudy-day	48	0.0001	
11/15/2017 16:00	1083	495	588	partly-cloudy-day	47	0.0002	
11/15/2017 17:00	840	415	425	cloudy	47	0.0001	
11/15/2017 18:00	575	363	212	cloudy	47	0	
11/15/2017 19:00	383	232	151	partly-cloudy-night	47	0.0001	
11/15/2017 20:00	284	199	85	partly-cloudy-night	47	0.0001	
11/15/2017 21:00	200	154	46	partly-cloudy-night	47	0.0001	
11/15/2017 22:00	142	101	41	partly-cloudy-night	47	0.0005	
11/15/2017 23:00	97	74	23	partly-cloudy-night	48	0.0002	
11/16/2017 0:00	36	20	16	partly-cloudy-night	49	0.0001	
11/16/2017 1:00	9	5	4	partly-cloudy-night	50	0.0001	
11/16/2017 2:00	4	3	1	partly-cloudy-night	50	0.0025	
11/16/2017 3:00	5	4	1	partly-cloudy-night	51	0.0018	
11/16/2017 4:00	6	4	2	partly-cloudy-night	51	0.003	
11/16/2017 5:00	5	4	1	partly-cloudy-night	51	0.0086	
11/16/2017 6:00	32	17	15	partly-cloudy-night	50	0.0237	
11/16/2017 7:00	55	26	29	rain	50	0.0443	
11/16/2017 8:00	180	68	112	rain	50	0.0784	
11/16/2017 9:00	247	118	129	partly-cloudy-day	50	0.0195	
11/16/2017 10:00	513	242	271	partly-cloudy-day	51	0.0043	
11/16/2017 11:00	800	384	416	partly-cloudy-day	51	0.0004	
11/16/2017 12:00	928	515	413	partly-cloudy-day	54	0.001	
11/16/2017 13:00	1035	449	586	partly-cloudy-day	55	0.0005	
11/16/2017 14:00	1066	505	561	clear-day	55	0.0001	
11/16/2017 15:00	1035	479	556	partly-cloudy-day	52	0.0033	
11/16/2017 16:00	984	518	466	clear-day	51	0.0013	
11/16/2017 17:00	848	469	379	clear-night	49	0.0003	
11/16/2017 18:00	576	346	230	clear-night	48	0.0001	
11/16/2017 19:00	364	232	132	clear-night	48	0.0002	
11/16/2017 20:00	242	192	50	clear-night	47	0.0002	
11/16/2017 21:00	202	145	57	clear-night	46	0	
11/16/2017 22:00	132	108	24	clear-night	45	0.0005	
11/16/2017 23:00	63	46	17	partly-cloudy-night	43	0.0005	
11/17/2017 0:00	31	17	14	partly-cloudy-night	43	0.0002	
11/17/2017 1:00	15	6	9	partly-cloudy-night	43	0.0004	
11/17/2017 2:00	5	1	4	clear-night	42	0.0002	
11/17/2017 3:00	8	5	3	clear-night	42	0	
11/17/2017 4:00	2	1	1	partly-cloudy-night	42	0	
11/17/2017 5:00	25	11	14	partly-cloudy-night	41	0	
11/17/2017 6:00	107	60	47	partly-cloudy-night	40	0	
11/17/2017 7:00	179	70	109	clear-day	39	0.0001	
11/17/2017 8:00	306	128	178	clear-day	40	0.0001	
11/17/2017 9:00	503	275	228	clear-day	41	0.0008	
11/17/2017 10:00	917	527	390	clear-day	42	0	
11/17/2017 11:00	1248	598	650	clear-day	43	0	
11/17/2017 12:00	1410	630	780	clear-day	45	0.0012	
11/17/2017 13:00	1456	646	810	clear-day	46	0.0026	
11/17/2017 14:00	1583	686	897	clear-day	47	0.0001	
11/17/2017 15:00	1844	881	963	clear-day	47	0	
11/17/2017 16:00	1803	843	960	clear-day	46	0	
11/17/2017 17:00	1011	477	534	clear-night	44	0	
11/17/2017 18:00	518	298	220	clear-night	43	0	
11/17/2017 19:00	257	143	114	clear-night	41	0.0001	
11/17/2017 20:00	170	101	69	clear-night	40	0	
11/17/2017 21:00	160	93	67	clear-night	39	0.0001	
11/17/2017 22:00	129	60	69	clear-night	37	0	
11/17/2017 23:00	139	81	58	clear-night	36	0	
11/18/2017 0:00	120	102	18	clear-night	35	0	
11/18/2017 1:00	37	26	11	clear-night	34	0	
11/18/2017 2:00	20	15	5	clear-night	33	0	
11/18/2017 3:00	21	6	15	clear-night	32	0	
11/18/2017 4:00	11	3	8	clear-night	31	0	
11/18/2017 5:00	7	6	1	clear-night	30	0	
11/18/2017 6:00	28	20	8	clear-night	31	0	
11/18/2017 7:00	89	34	55	clear-day	32	0	
11/18/2017 8:00	190	106	84	clear-day	34	0	
11/18/2017 9:00	442	257	185	clear-day	37	0	
11/18/2017 10:00	1021	546	475	clear-day	40	0.0008	
11/18/2017 11:00	1581	735	846	clear-day	43	0.0024	
11/18/2017 12:00	1910	871	1039	clear-day	46	0.0019	
11/18/2017 13:00	1900	782	1118	clear-day	48	0.0009	
11/18/2017 14:00	1740	726	1014	partly-cloudy-day	49	0.0002	
11/18/2017 15:00	1463	703	760	partly-cloudy-day	50	0.0005	
11/18/2017 16:00	986	422	564	partly-cloudy-day	49	0.0058	
11/18/2017 17:00	378	189	189	partly-cloudy-night	48	0.0175	
11/18/2017 18:00	197	120	77	rain	48	0.0274	
11/18/2017 19:00	170	121	49	rain	47	0.0293	
11/18/2017 20:00	107	55	52	partly-cloudy-night	48	0.0175	
11/18/2017 21:00	143	99	44	partly-cloudy-night	48	0.0065	
11/18/2017 22:00	181	121	60	rain	49	0.0693	
11/18/2017 23:00	116	90	26	partly-cloudy-night	51	0.0026	
11/19/2017 0:00	94	88	6	clear-night	52	0.0014	
11/19/2017 1:00	31	13	18	clear-night	53	0.0008	
11/19/2017 2:00	15	9	6	partly-cloudy-night	54	0.0027	
11/19/2017 3:00	3	1	2	partly-cloudy-night	55	0.0089	
11/19/2017 4:00	4	3	1	partly-cloudy-night	56	0.0169	
11/19/2017 5:00	3	2	1	rain	57	0.0423	
11/19/2017 6:00	23	16	7	rain	57	0.0944	
11/19/2017 7:00	56	36	20	partly-cloudy-day	57	0.0233	
11/19/2017 8:00	184	110	74	partly-cloudy-day	54	0.0241	
11/19/2017 9:00	519	311	208	partly-cloudy-day	52	0.0071	
11/19/2017 10:00	1072	599	473	partly-cloudy-day	51	0.0009	
11/19/2017 11:00	1476	753	723	partly-cloudy-day	50	0.0011	
11/19/2017 12:00	1732	857	875	partly-cloudy-day	49	0.0004	
11/19/2017 13:00	2043	918	1125	partly-cloudy-day	50	0.0002	
11/19/2017 14:00	2069	895	1174	partly-cloudy-day	49	0.0001	
11/19/2017 15:00	2100	914	1186	partly-cloudy-day	48	0	
11/19/2017 16:00	1992	846	1146	partly-cloudy-day	46	0	
11/19/2017 17:00	1067	396	671	clear-night	45	0.0001	
11/19/2017 18:00	541	242	299	partly-cloudy-night	45	0	
11/19/2017 19:00	369	206	163	partly-cloudy-night	45	0	
11/19/2017 20:00	255	107	148	partly-cloudy-night	44	0.0001	
11/19/2017 21:00	165	101	64	partly-cloudy-night	43	0.0001	
11/19/2017 22:00	84	26	58	partly-cloudy-night	42	0.0003	
11/19/2017 23:00	38	20	18	partly-cloudy-night	40	0.0009	
11/20/2017 0:00	28	6	22	partly-cloudy-night	39	0.0005	
11/20/2017 1:00	7	3	4	partly-cloudy-night	39	0.0003	
11/20/2017 2:00	11	4	7	partly-cloudy-night	38	0.0001	
11/20/2017 3:00	1	0	1	partly-cloudy-night	38	0.0001	
11/20/2017 4:00	1	0	1	partly-cloudy-night	37	0.0001	
11/20/2017 5:00	15	9	6	partly-cloudy-night	37	0	
11/20/2017 6:00	89	51	38	partly-cloudy-night	36	0	
11/20/2017 7:00	162	75	87	partly-cloudy-day	36	0	
11/20/2017 8:00	272	105	167	partly-cloudy-day	37	0	
11/20/2017 9:00	517	286	231	partly-cloudy-day	38	0.0053	
11/20/2017 10:00	1025	583	442	partly-cloudy-day	40	0.0012	
11/20/2017 11:00	1252	606	646	partly-cloudy-day	42	0.0002	
11/20/2017 12:00	1509	675	834	partly-cloudy-day	44	0	
11/20/2017 13:00	1512	626	886	partly-cloudy-day	45	0.0001	
11/20/2017 14:00	1490	697	793	clear-day	46	0.0015	
11/20/2017 15:00	1650	794	856	clear-day	46	0.0004	
11/20/2017 16:00	1669	736	933	clear-day	45	0	
11/20/2017 17:00	952	437	515	clear-night	44	0.0035	
11/20/2017 18:00	612	410	202	rain	43	0.0592	
11/20/2017 19:00	401	255	146	rain	43	0.0642	
11/20/2017 20:00	274	190	84	clear-night	42	0	
11/20/2017 21:00	157	99	58	clear-night	42	0	
11/20/2017 22:00	86	48	38	clear-night	41	0	
11/20/2017 23:00	69	39	30	clear-night	41	0.0032	
11/21/2017 0:00	105	92	13	clear-night	40	0	
11/21/2017 1:00	11	6	5	clear-night	40	0	
11/21/2017 2:00	10	5	5	clear-night	40	0	
11/21/2017 3:00	1	0	1	clear-night	40	0	
11/21/2017 4:00	5	3	2	clear-night	40	0.0001	
11/21/2017 5:00	22	10	12	clear-night	39	0	
11/21/2017 6:00	79	39	40	clear-night	39	0	
11/21/2017 7:00	189	84	105	clear-day	39	0.0001	
11/21/2017 8:00	355	129	226	clear-day	41	0	
11/21/2017 9:00	535	280	255	clear-day	46	0.0004	
11/21/2017 10:00	1099	654	445	clear-day	50	0.0001	
11/21/2017 11:00	1735	862	873	clear-day	52	0.0001	
11/21/2017 12:00	1801	860	941	clear-day	54	0	
11/21/2017 13:00	1855	802	1053	clear-day	56	0.0001	
11/21/2017 14:00	1966	808	1158	clear-day	57	0	
11/21/2017 15:00	2241	1035	1206	clear-day	57	0	
11/21/2017 16:00	1867	805	1062	clear-day	55	0	
11/21/2017 17:00	1282	509	773	clear-night	53	0	
11/21/2017 18:00	800	462	338	clear-night	51	0	
11/21/2017 19:00	485	316	169	clear-night	50	0	
11/21/2017 20:00	316	225	91	clear-night	49	0	
11/21/2017 21:00	258	182	76	clear-night	49	0	
11/21/2017 22:00	200	147	53	clear-night	48	0	
11/21/2017 23:00	61	27	34	clear-night	48	0	
11/22/2017 0:00	40	27	13	clear-night	48	0	
11/22/2017 1:00	14	7	7	clear-night	47	0	
11/22/2017 2:00	16	12	4	clear-night	47	0.0002	
11/22/2017 3:00	10	8	2	clear-night	47	0.0011	
11/22/2017 4:00	5	4	1	clear-night	47	0.0023	
11/22/2017 5:00	20	10	10	partly-cloudy-night	48	0.0018	
11/22/2017 6:00	46	22	24	partly-cloudy-night	49	0.0016	
11/22/2017 7:00	84	38	46	partly-cloudy-day	49	0.0089	
11/22/2017 8:00	112	44	68	rain	49	0.0315	
11/22/2017 9:00	113	73	40	rain	49	0.0395	
11/22/2017 10:00	482	284	198	partly-cloudy-day	49	0.0245	
11/22/2017 11:00	928	529	399	rain	50	0.0692	
11/22/2017 12:00	1043	514	529	partly-cloudy-day	50	0.0013	
11/22/2017 13:00	1431	658	773	partly-cloudy-day	51	0.0008	
11/22/2017 14:00	1519	720	799	clear-day	51	0.0012	
11/22/2017 15:00	1603	738	865	partly-cloudy-day	49	0.0002	
11/22/2017 16:00	1516	692	824	partly-cloudy-day	46	0.0005	
11/22/2017 17:00	837	400	437	partly-cloudy-night	44	0.0002	
11/22/2017 18:00	463	275	188	partly-cloudy-night	42	0	
11/22/2017 19:00	210	103	107	partly-cloudy-night	41	0.0001	
11/22/2017 20:00	185	92	93	partly-cloudy-night	39	0.0001	
11/22/2017 21:00	95	46	49	clear-night	38	0.004	
11/22/2017 22:00	57	29	28	clear-night	36	0	
11/22/2017 23:00	68	46	22	clear-night	36	0	
11/23/2017 0:00	28	17	11	clear-night	35	0	Thanksgiving Day
11/23/2017 1:00	16	4	12	clear-night	34	0	Thanksgiving Day
11/23/2017 2:00	3	1	2	clear-night	33	0	Thanksgiving Day
11/23/2017 3:00	5	3	2	clear-night	32	0	Thanksgiving Day
11/23/2017 4:00	0	0	0	clear-night	32	0	Thanksgiving Day
11/23/2017 5:00	12	7	5	clear-night	31	0	Thanksgiving Day
11/23/2017 6:00	78	55	23	clear-night	31	0	Thanksgiving Day
11/23/2017 7:00	119	47	72	clear-day	30	0	Thanksgiving Day
11/23/2017 8:00	185	94	91	clear-day	31	0	Thanksgiving Day
11/23/2017 9:00	313	167	146	clear-day	34	0	Thanksgiving Day
11/23/2017 10:00	589	329	260	clear-day	35	0.0001	Thanksgiving Day
11/23/2017 11:00	1076	552	524	clear-day	38	0.0025	Thanksgiving Day
11/23/2017 12:00	1567	755	812	clear-day	39	0.0002	Thanksgiving Day
11/23/2017 13:00	1746	793	953	clear-day	41	0.0003	Thanksgiving Day
11/23/2017 14:00	2142	1113	1029	clear-day	42	0.0002	Thanksgiving Day
11/23/2017 15:00	2298	1168	1130	clear-day	43	0.0002	Thanksgiving Day
11/23/2017 16:00	2226	1040	1186	clear-day	42	0.0003	Thanksgiving Day
11/23/2017 17:00	1146	457	689	clear-night	40	0.0002	Thanksgiving Day
11/23/2017 18:00	512	233	279	clear-night	38	0	Thanksgiving Day
11/23/2017 19:00	228	82	146	clear-night	37	0	Thanksgiving Day
11/23/2017 20:00	184	104	80	clear-night	36	0	Thanksgiving Day
11/23/2017 21:00	105	52	53	clear-night	35	0	Thanksgiving Day
11/23/2017 22:00	70	35	35	clear-night	35	0	Thanksgiving Day
11/23/2017 23:00	45	29	16	clear-night	34	0	Thanksgiving Day
11/24/2017 0:00	31	9	22	clear-night	33	0	Black Friday
11/24/2017 1:00	24	7	17	clear-night	32	0	Black Friday
11/24/2017 2:00	8	7	1	clear-night	32	0	Black Friday
11/24/2017 3:00	3	0	3	clear-night	31	0	Black Friday
11/24/2017 4:00	3	1	2	clear-night	31	0	Black Friday
11/24/2017 5:00	5	3	2	clear-night	31	0	Black Friday
11/24/2017 6:00	44	24	20	clear-night	30	0	Black Friday
11/24/2017 7:00	110	54	56	clear-day	31	0	Black Friday
11/24/2017 8:00	184	94	90	clear-day	33	0	Black Friday
11/24/2017 9:00	497	304	193	clear-day	37	0	Black Friday
11/24/2017 10:00	1176	625	551	clear-day	41	0	Black Friday
11/24/2017 11:00	1754	775	979	clear-day	44	0.0012	Black Friday
11/24/2017 12:00	2044	935	1109	clear-day	47	0.0009	Black Friday
11/24/2017 13:00	2347	1024	1323	clear-day	49	0.0003	Black Friday
11/24/2017 14:00	2344	1030	1314	clear-day	50	0.0002	Black Friday
11/24/2017 15:00	2913	1311	1602	clear-day	50	0	Black Friday
11/24/2017 16:00	2877	1307	1570	clear-day	49	0	Black Friday
11/24/2017 17:00	1436	490	946	clear-night	46	0	Black Friday
11/24/2017 18:00	757	291	466	clear-night	45	0.0001	Black Friday
11/24/2017 19:00	539	258	281	clear-night	44	0	Black Friday
11/24/2017 20:00	355	173	182	clear-night	42	0	Black Friday
11/24/2017 21:00	292	120	172	clear-night	42	0	Black Friday
11/24/2017 22:00	161	69	92	clear-night	41	0	Black Friday
11/24/2017 23:00	96	46	50	clear-night	40	0	Black Friday
11/25/2017 0:00	27	8	19	clear-night	39	0	
11/25/2017 1:00	34	24	10	clear-night	38	0	
11/25/2017 2:00	17	3	14	clear-night	38	0	
11/25/2017 3:00	16	6	10	clear-night	37	0	
11/25/2017 4:00	1	0	1	clear-night	37	0	
11/25/2017 5:00	9	4	5	clear-night	36	0	
11/25/2017 6:00	56	35	21	clear-night	35	0	
11/25/2017 7:00	147	69	78	clear-day	35	0	
11/25/2017 8:00	302	159	143	clear-day	37	0	
11/25/2017 9:00	704	465	239	clear-day	42	0	
11/25/2017 10:00	1516	886	630	clear-day	47	0	
11/25/2017 11:00	2286	1130	1156	clear-day	50	0	
11/25/2017 12:00	2733	1235	1498	clear-day	53	0.0004	
11/25/2017 13:00	2754	1256	1498	clear-day	55	0.0002	
11/25/2017 14:00	3195	1380	1815	clear-day	56	0	
11/25/2017 15:00	3390	1556	1834	clear-day	56	0.0002	
11/25/2017 16:00	3191	1527	1664	clear-day	55	0.0006	
11/25/2017 17:00	1779	667	1112	clear-night	54	0	
11/25/2017 18:00	1014	363	651	partly-cloudy-night	54	0	
11/25/2017 19:00	622	268	354	partly-cloudy-night	53	0	
11/25/2017 20:00	527	268	259	clear-night	52	0	
11/25/2017 21:00	427	250	177	clear-night	50	0	
11/25/2017 22:00	287	130	157	partly-cloudy-night	49	0	
11/25/2017 23:00	224	144	80	partly-cloudy-night	49	0	
11/26/2017 0:00	58	27	31	partly-cloudy-night	49	0	
11/26/2017 1:00	21	11	10	partly-cloudy-night	49	0	
11/26/2017 2:00	26	15	11	partly-cloudy-night	48	0	
11/26/2017 3:00	5	2	3	partly-cloudy-night	47	0	
11/26/2017 4:00	3	1	2	partly-cloudy-night	46	0	
11/26/2017 5:00	13	8	5	clear-night	45	0	
11/26/2017 6:00	48	38	10	clear-night	43	0	
11/26/2017 7:00	170	84	86	clear-night	43	0	
11/26/2017 8:00	289	158	131	clear-day	44	0	
11/26/2017 9:00	574	343	231	partly-cloudy-day	45	0.0004	
11/26/2017 10:00	1080	591	489	partly-cloudy-day	45	0.0001	
11/26/2017 11:00	1444	722	722	partly-cloudy-day	45	0	
11/26/2017 12:00	1657	808	849	clear-day	46	0.0001	
11/26/2017 13:00	1827	806	1021	clear-day	47	0	
11/26/2017 14:00	1906	756	1150	clear-day	46	0	
11/26/2017 15:00	1862	855	1007	clear-day	45	0	
11/26/2017 16:00	1717	715	1002	clear-day	45	0	
11/26/2017 17:00	1051	403	648	clear-night	43	0	
11/26/2017 18:00	556	285	271	clear-night	42	0	
11/26/2017 19:00	318	163	155	clear-night	40	0	
11/26/2017 20:00	225	117	108	clear-night	38	0	
11/26/2017 21:00	146	66	80	clear-night	37	0	
11/26/2017 22:00	72	22	50	clear-night	37	0	
11/26/2017 23:00	25	13	12	clear-night	37	0	
11/27/2017 0:00	31	7	24	clear-night	38	0	
11/27/2017 1:00	17	9	8	clear-night	38	0	
11/27/2017 2:00	3	0	3	clear-night	38	0	
11/27/2017 3:00	6	3	3	clear-night	38	0	
11/27/2017 4:00	3	2	1	clear-night	38	0	
11/27/2017 5:00	18	8	10	clear-night	38	0	
11/27/2017 6:00	96	53	43	clear-night	38	0	
11/27/2017 7:00	165	75	90	clear-night	38	0	
11/27/2017 8:00	273	111	162	clear-day	40	0	
11/27/2017 9:00	485	284	201	clear-day	43	0	
11/27/2017 10:00	957	507	450	clear-day	45	0	
11/27/2017 11:00	1224	582	642	clear-day	47	0	
11/27/2017 12:00	1254	573	681	clear-day	48	0	
11/27/2017 13:00	1374	561	813	clear-day	50	0	
11/27/2017 14:00	1333	575	758	clear-day	50	0	
11/27/2017 15:00	1263	595	668	clear-day	51	0	
11/27/2017 16:00	1364	619	745	clear-day	50	0	
11/27/2017 17:00	956	476	480	clear-night	48	0	
11/27/2017 18:00	580	364	216	clear-night	46	0.0004	
11/27/2017 19:00	329	234	95	clear-night	44	0	
11/27/2017 20:00	245	171	74	clear-night	43	0	
11/27/2017 21:00	101	49	52	clear-night	41	0	
11/27/2017 22:00	66	43	23	clear-night	40	0	
11/27/2017 23:00	30	16	14	clear-night	38	0	
11/28/2017 0:00	35	15	20	clear-night	37	0	
11/28/2017 1:00	9	7	2	clear-night	36	0	
11/28/2017 2:00	2	1	1	clear-night	35	0	
11/28/2017 3:00	5	3	2	clear-night	35	0	
11/28/2017 4:00	6	4	2	clear-night	34	0	
11/28/2017 5:00	17	9	8	clear-night	34	0	
11/28/2017 6:00	98	54	44	clear-night	34	0	
11/28/2017 7:00	191	83	108	clear-night	33	0	
11/28/2017 8:00	311	99	212	clear-day	35	0	
11/28/2017 9:00	383	180	203	clear-day	38	0	
11/28/2017 10:00	593	327	266	clear-day	41	0	
11/28/2017 11:00	848	390	458	clear-day	44	0.0003	
11/28/2017 12:00	1118	515	603	clear-day	47	0	
11/28/2017 13:00	1193	478	715	clear-day	49	0	
11/28/2017 14:00	1167	451	716	clear-day	50	0	
11/28/2017 15:00	1231	560	671	clear-day	51	0.0004	
11/28/2017 16:00	1223	561	662	partly-cloudy-day	51	0	
11/28/2017 17:00	787	394	393	clear-night	53	0.0002	
11/28/2017 18:00	561	361	200	clear-night	49	0	
11/28/2017 19:00	361	237	124	clear-night	49	0.0005	
11/28/2017 20:00	270	200	70	clear-night	49	0	
11/28/2017 21:00	147	96	51	clear-night	49	0	
11/28/2017 22:00	69	30	39	clear-night	49	0	
11/28/2017 23:00	43	21	22	clear-night	48	0	
11/29/2017 0:00	24	11	13	clear-night	48	0	
11/29/2017 1:00	11	7	4	clear-night	48	0	
11/29/2017 2:00	7	5	2	clear-night	48	0	
11/29/2017 3:00	3	1	2	clear-night	47	0	
11/29/2017 4:00	1	0	1	clear-night	47	0	
11/29/2017 5:00	22	12	10	clear-night	47	0	
11/29/2017 6:00	78	46	32	clear-night	46	0	
11/29/2017 7:00	208	85	123	clear-night	46	0	
11/29/2017 8:00	356	130	226	partly-cloudy-day	47	0	
11/29/2017 9:00	399	179	220	partly-cloudy-day	49	0	
11/29/2017 10:00	629	366	263	partly-cloudy-day	52	0	
11/29/2017 11:00	998	475	523	clear-day	57	0.001	
11/29/2017 12:00	994	414	580	clear-day	61	0.0008	
11/29/2017 13:00	1125	492	633	clear-day	62	0.0003	
11/29/2017 14:00	1211	561	650	clear-day	63	0	
11/29/2017 15:00	1293	633	660	clear-day	62	0.0059	
11/29/2017 16:00	1261	536	725	clear-day	59	0	
11/29/2017 17:00	773	393	380	clear-night	55	0.0011	
11/29/2017 18:00	508	335	173	clear-night	52	0	
11/29/2017 19:00	386	284	102	clear-night	50	0.0001	
11/29/2017 20:00	258	198	60	clear-night	47	0	
11/29/2017 21:00	168	131	37	clear-night	46	0	
11/29/2017 22:00	85	55	30	clear-night	43	0	
11/29/2017 23:00	103	85	18	clear-night	42	0	
11/30/2017 0:00	32	15	17	clear-night	40	0	
11/30/2017 1:00	10	4	6	clear-night	39	0	
11/30/2017 2:00	3	1	2	clear-night	38	0	
11/30/2017 3:00	1	0	1	clear-night	36	0	
11/30/2017 4:00	3	2	1	clear-night	36	0	
11/30/2017 5:00	32	16	16	clear-night	35	0	
11/30/2017 6:00	83	47	36	clear-night	34	0	
11/30/2017 7:00	172	74	98	clear-night	36	0	
11/30/2017 8:00	291	103	188	clear-day	36	0	
11/30/2017 9:00	400	213	187	clear-day	38	0	
11/30/2017 10:00	635	327	308	clear-day	40	0	
11/30/2017 11:00	962	458	504	partly-cloudy-day	43	0	
11/30/2017 12:00	1181	520	661	partly-cloudy-day	44	0	
11/30/2017 13:00	1201	513	688	partly-cloudy-day	46	0	
11/30/2017 14:00	1278	543	735	partly-cloudy-day	48	0	
11/30/2017 15:00	1289	598	691	partly-cloudy-day	49	0	
11/30/2017 16:00	1179	561	618	partly-cloudy-day	49	0	
11/30/2017 17:00	844	411	433	clear-night	47	0	
11/30/2017 18:00	480	305	175	clear-night	46	0.0001	
11/30/2017 19:00	396	260	136	clear-night	46	0.0004	
11/30/2017 20:00	283	183	100	partly-cloudy-night	47	0	
11/30/2017 21:00	241	171	70	partly-cloudy-night	47	0	
11/30/2017 22:00	172	132	40	partly-cloudy-night	48	0.0014	
11/30/2017 23:00	67	56	11	partly-cloudy-night	47	0.0017	
12/1/2017 0:00	27	21	6	partly-cloudy-night	47	0.01	
12/1/2017 1:00	11	7	4	partly-cloudy-night	47	0.0037	
12/1/2017 2:00	6	2	4	partly-cloudy-night	47	0.0004	
12/1/2017 3:00	3	2	1	partly-cloudy-night	46	0	
12/1/2017 4:00	3	2	1	partly-cloudy-night	45	0	
12/1/2017 5:00	23	15	8	clear-night	44	0.0003	
12/1/2017 6:00	100	64	36	clear-night	43	0.0004	
12/1/2017 7:00	212	86	126	clear-night	42	0.0001	
12/1/2017 8:00	316	126	190	clear-day	43	0.0001	
12/1/2017 9:00	555	254	301	clear-day	46	0.0004	
12/1/2017 10:00	1053	565	488	clear-day	49	0.0002	
12/1/2017 11:00	1425	604	821	clear-day	50	0.0003	
12/1/2017 12:00	1644	669	975	clear-day	51	0.0005	
12/1/2017 13:00	1632	678	954	clear-day	51	0	
12/1/2017 14:00	1842	822	1020	clear-day	51	0	
12/1/2017 15:00	1814	826	988	clear-day	50	0	
12/1/2017 16:00	1796	850	946	clear-day	49	0.0035	
12/1/2017 17:00	1069	546	523	clear-night	47	0.0003	
12/1/2017 18:00	593	328	265	clear-night	45	0	
12/1/2017 19:00	326	191	135	clear-night	44	0	
12/1/2017 20:00	189	94	95	clear-night	43	0	
12/1/2017 21:00	144	65	79	clear-night	41	0	
12/1/2017 22:00	144	98	46	clear-night	40	0	
12/1/2017 23:00	141	113	28	clear-night	39	0	
12/2/2017 0:00	111	87	24	clear-night	38	0	
12/2/2017 1:00	47	38	9	clear-night	37	0	
12/2/2017 2:00	15	9	6	clear-night	36	0	
12/2/2017 3:00	1	0	1	clear-night	36	0	
12/2/2017 4:00	8	4	4	clear-night	34	0	
12/2/2017 5:00	17	8	9	clear-night	34	0	
12/2/2017 6:00	53	36	17	clear-night	34	0	
12/2/2017 7:00	210	106	104	clear-night	34	0	
12/2/2017 8:00	243	130	113	clear-day	34	0	
12/2/2017 9:00	754	418	336	clear-day	38	0	
12/2/2017 10:00	1305	698	607	clear-day	43	0	
12/2/2017 11:00	2331	1154	1177	clear-day	45	0.0005	
12/2/2017 12:00	2629	1265	1364	clear-day	46	0	
12/2/2017 13:00	2649	1152	1497	clear-day	47	0	
12/2/2017 14:00	2733	1208	1525	clear-day	47	0	
12/2/2017 15:00	2806	1234	1572	clear-day	47	0	
12/2/2017 16:00	2484	1115	1369	clear-day	46	0	
12/2/2017 17:00	1336	502	834	clear-night	45	0	
12/2/2017 18:00	911	374	537	clear-night	44	0	
12/2/2017 19:00	547	256	291	clear-night	43	0	
12/2/2017 20:00	345	150	195	clear-night	42	0	
12/2/2017 21:00	272	113	159	clear-night	41	0	
12/2/2017 22:00	208	128	80	clear-night	40	0	
12/2/2017 23:00	199	142	57	clear-night	40	0	
12/3/2017 0:00	157	131	26	partly-cloudy-night	40	0	
12/3/2017 1:00	68	46	22	partly-cloudy-night	39	0	
12/3/2017 2:00	12	4	8	clear-night	39	0	
12/3/2017 3:00	11	9	2	clear-night	39	0	
12/3/2017 4:00	10	6	4	partly-cloudy-night	39	0	
12/3/2017 5:00	19	12	7	partly-cloudy-night	40	0	
12/3/2017 6:00	53	42	11	partly-cloudy-night	40	0	
12/3/2017 7:00	175	97	78	partly-cloudy-night	41	0	
12/3/2017 8:00	297	143	154	partly-cloudy-day	41	0	
12/3/2017 9:00	710	431	279	partly-cloudy-day	43	0	
12/3/2017 10:00	1238	603	635	partly-cloudy-day	44	0	
12/3/2017 11:00	1737	907	830	partly-cloudy-day	46	0	
12/3/2017 12:00	1853	819	1034	partly-cloudy-day	47	0	
12/3/2017 13:00	1995	886	1109	partly-cloudy-day	47	0	
12/3/2017 14:00	1869	746	1123	partly-cloudy-day	47	0	
12/3/2017 15:00	1865	853	1012	partly-cloudy-day	47	0	
12/3/2017 16:00	1587	634	953	partly-cloudy-day	47	0.0001	
12/3/2017 17:00	1022	433	589	partly-cloudy-night	46	0	
12/3/2017 18:00	671	303	368	partly-cloudy-night	45	0	
12/3/2017 19:00	464	250	214	partly-cloudy-night	44	0	
12/3/2017 20:00	420	238	182	partly-cloudy-night	43	0	
12/3/2017 21:00	271	150	121	clear-night	41	0	
12/3/2017 22:00	128	63	65	clear-night	41	0	
12/3/2017 23:00	79	37	42	clear-night	39	0	
12/4/2017 0:00	36	14	22	clear-night	38	0	
12/4/2017 1:00	23	9	14	clear-night	38	0	
12/4/2017 2:00	5	3	2	clear-night	36	0	
12/4/2017 3:00	3	2	1	clear-night	36	0	
12/4/2017 4:00	8	3	5	partly-cloudy-night	35	0	
12/4/2017 5:00	19	13	6	partly-cloudy-night	34	0.0019	
12/4/2017 6:00	80	46	34	partly-cloudy-night	34	0	
12/4/2017 7:00	196	86	110	partly-cloudy-night	34	0.0001	
12/4/2017 8:00	389	146	243	partly-cloudy-day	35	0.0002	
12/4/2017 9:00	640	375	265	partly-cloudy-day	37	0.0002	
12/4/2017 10:00	1076	538	538	clear-day	41	0.0004	
12/4/2017 11:00	1586	668	918	clear-day	44	0.0001	
12/4/2017 12:00	1693	701	992	clear-day	47	0.0001	
12/4/2017 13:00	1781	766	1015	clear-day	49	0	
12/4/2017 14:00	1818	813	1005	clear-day	49	0	
12/4/2017 15:00	1922	929	993	clear-day	49	0	
12/4/2017 16:00	1768	841	927	clear-day	48	0	
12/4/2017 17:00	1080	485	595	clear-night	47	0	
12/4/2017 18:00	800	461	339	clear-night	46	0.0001	
12/4/2017 19:00	409	257	152	partly-cloudy-night	46	0	
12/4/2017 20:00	278	160	118	partly-cloudy-night	47	0	
12/4/2017 21:00	179	85	94	partly-cloudy-night	47	0	
12/4/2017 22:00	172	128	44	partly-cloudy-night	48	0	
12/4/2017 23:00	40	14	26	partly-cloudy-night	48	0	
12/5/2017 0:00	13	8	5	partly-cloudy-night	48	0	
12/5/2017 1:00	10	5	5	partly-cloudy-night	49	0	
12/5/2017 2:00	6	0	6	partly-cloudy-night	49	0	
12/5/2017 3:00	4	0	4	partly-cloudy-night	50	0	
12/5/2017 4:00	5	4	1	partly-cloudy-night	50	0	
12/5/2017 5:00	31	18	13	partly-cloudy-night	50	0	
12/5/2017 6:00	101	41	60	partly-cloudy-night	51	0	
12/5/2017 7:00	168	75	93	partly-cloudy-night	51	0	
12/5/2017 8:00	241	96	145	partly-cloudy-day	52	0	
12/5/2017 9:00	337	138	199	partly-cloudy-day	53	0.0001	
12/5/2017 10:00	540	274	266	partly-cloudy-day	54	0.0001	
12/5/2017 11:00	849	386	463	partly-cloudy-day	55	0.0006	
12/5/2017 12:00	931	457	474	partly-cloudy-day	57	0.0025	
12/5/2017 13:00	1073	444	629	partly-cloudy-day	59	0.0002	
12/5/2017 14:00	1046	418	628	partly-cloudy-day	59	0.0001	
12/5/2017 15:00	957	365	592	partly-cloudy-day	59	0.0001	
12/5/2017 16:00	696	335	361	partly-cloudy-day	59	0.0027	
12/5/2017 17:00	479	294	185	partly-cloudy-night	59	0.0005	
12/5/2017 18:00	341	245	96	partly-cloudy-night	58	0.0025	
12/5/2017 19:00	136	55	81	partly-cloudy-night	57	0.0081	
12/5/2017 20:00	47	38	9	rain	57	0.0362	
12/5/2017 21:00	43	39	4	rain	57	0.065	
12/5/2017 22:00	37	34	3	rain	56	0.0918	
12/5/2017 23:00	28	25	3	rain	56	0.0659	
12/6/2017 0:00	12	10	2	rain	56	0.0334	
12/6/2017 1:00	14	10	4	partly-cloudy-night	56	0.0037	
12/6/2017 2:00	4	0	4	partly-cloudy-night	56	0.001	
12/6/2017 3:00	0	0	0	partly-cloudy-night	55	0.0004	
12/6/2017 4:00	2	0	2	partly-cloudy-night	50	0.002	
12/6/2017 5:00	17	10	7	partly-cloudy-night	49	0.0007	
12/6/2017 6:00	71	36	35	partly-cloudy-night	48	0.0002	
12/6/2017 7:00	160	63	97	cloudy	46	0.0001	
12/6/2017 8:00	292	114	178	partly-cloudy-day	44	0	
12/6/2017 9:00	422	189	233	clear-day	42	0.0002	
12/6/2017 10:00	767	364	403	clear-day	41	0	
12/6/2017 11:00	1109	485	624	clear-day	40	0	
12/6/2017 12:00	1166	444	722	clear-day	41	0	
12/6/2017 13:00	1291	452	839	clear-day	42	0	
12/6/2017 14:00	1355	612	743	clear-day	42	0.0006	
12/6/2017 15:00	1340	611	729	clear-day	43	0	
12/6/2017 16:00	1186	579	607	clear-day	42	0	
12/6/2017 17:00	727	403	324	clear-night	41	0.0007	
12/6/2017 18:00	561	394	167	clear-night	41	0.0005	
12/6/2017 19:00	381	261	120	clear-night	40	0	
12/6/2017 20:00	294	225	69	clear-night	40	0	
12/6/2017 21:00	219	173	46	clear-night	39	0	
12/6/2017 22:00	184	150	34	clear-night	39	0.0003	
12/6/2017 23:00	121	106	15	clear-night	38	0	
12/7/2017 0:00	26	15	11	partly-cloudy-night	38	0	
12/7/2017 1:00	23	12	11	partly-cloudy-night	38	0	
12/7/2017 2:00	3	2	1	partly-cloudy-night	38	0	
12/7/2017 3:00	1	0	1	clear-night	37	0	
12/7/2017 4:00	1	0	1	clear-night	37	0	
12/7/2017 5:00	26	11	15	clear-night	36	0	
12/7/2017 6:00	77	45	32	clear-night	36	0	
12/7/2017 7:00	152	59	93	clear-night	35	0	
12/7/2017 8:00	308	111	197	clear-day	36	0	
12/7/2017 9:00	412	191	221	clear-day	39	0	
12/7/2017 10:00	890	494	396	clear-day	41	0	
12/7/2017 11:00	1333	612	721	clear-day	42	0	
12/7/2017 12:00	1396	539	857	clear-day	44	0	
12/7/2017 13:00	1600	607	993	clear-day	44	0	
12/7/2017 14:00	1545	608	937	clear-day	44	0	
12/7/2017 15:00	1599	759	840	clear-day	44	0	
12/7/2017 16:00	1579	736	843	clear-day	43	0	
12/7/2017 17:00	880	447	433	clear-night	42	0	
12/7/2017 18:00	624	391	233	clear-night	41	0	
12/7/2017 19:00	335	221	114	clear-night	40	0	
12/7/2017 20:00	266	182	84	clear-night	39	0	
12/7/2017 21:00	229	164	65	partly-cloudy-night	40	0	
12/7/2017 22:00	178	131	47	partly-cloudy-night	39	0	
12/7/2017 23:00	119	100	19	clear-night	39	0	
12/8/2017 0:00	31	20	11	partly-cloudy-night	38	0	
12/8/2017 1:00	9	6	3	clear-night	37	0	
12/8/2017 2:00	11	7	4	clear-night	36	0	
12/8/2017 3:00	2	0	2	clear-night	36	0	
12/8/2017 4:00	2	0	2	clear-night	35	0	
12/8/2017 5:00	13	7	6	clear-night	34	0	
12/8/2017 6:00	63	36	27	clear-night	34	0	
12/8/2017 7:00	155	71	84	clear-night	33	0	
12/8/2017 8:00	295	98	197	clear-day	33	0.0002	
12/8/2017 9:00	471	241	230	clear-day	34	0	
12/8/2017 10:00	1003	543	460	clear-day	35	0	
12/8/2017 11:00	1363	592	771	partly-cloudy-day	35	0.0006	
12/8/2017 12:00	1679	753	926	clear-day	36	0	
12/8/2017 13:00	1721	722	999	clear-day	37	0	
12/8/2017 14:00	1701	730	971	clear-day	37	0	
12/8/2017 15:00	1813	869	944	clear-day	37	0	
12/8/2017 16:00	1415	573	842	clear-day	37	0.0004	
12/8/2017 17:00	895	423	472	clear-night	36	0.0001	
12/8/2017 18:00	433	210	223	partly-cloudy-night	36	0	
12/8/2017 19:00	289	140	149	partly-cloudy-night	36	0	
12/8/2017 20:00	195	88	107	partly-cloudy-night	36	0	
12/8/2017 21:00	200	107	93	partly-cloudy-night	35	0	
12/8/2017 22:00	90	35	55	partly-cloudy-night	35	0	
12/8/2017 23:00	77	54	23	partly-cloudy-night	35	0	
12/9/2017 0:00	105	84	21	partly-cloudy-night	35	0	
12/9/2017 1:00	29	16	13	partly-cloudy-night	35	0	
12/9/2017 2:00	7	4	3	partly-cloudy-night	34	0	
12/9/2017 3:00	9	5	4	partly-cloudy-night	35	0	
12/9/2017 4:00	9	4	5	partly-cloudy-night	34	0	
12/9/2017 5:00	8	2	6	partly-cloudy-night	34	0	
12/9/2017 6:00	24	9	15	partly-cloudy-night	34	0	
12/9/2017 7:00	89	46	43	partly-cloudy-night	34	0	
12/9/2017 8:00	170	70	100	partly-cloudy-day	34	0	
12/9/2017 9:00	480	266	214	partly-cloudy-day	34	0	
12/9/2017 10:00	821	396	425	partly-cloudy-day	33	0	
12/9/2017 11:00	970	527	443	fog	31	0.0015	
12/9/2017 12:00	942	505	437	fog	31	0.0022	
12/9/2017 13:00	840	423	417	fog	31	0.0034	
12/9/2017 14:00	715	464	251	fog	31	0.0044	
12/9/2017 15:00	652	364	288	fog	31	0.003	
12/9/2017 16:00	505	295	210	fog	31	0.0046	
12/9/2017 17:00	185	113	72	fog	30	0.0036	
12/9/2017 18:00	96	64	32	fog	30	0.0025	
12/9/2017 19:00	71	37	34	partly-cloudy-night	30	0.0024	
12/9/2017 20:00	59	40	19	partly-cloudy-night	31	0.0029	
12/9/2017 21:00	59	38	21	partly-cloudy-night	31	0.002	
12/9/2017 22:00	25	15	10	partly-cloudy-night	31	0.0017	
12/9/2017 23:00	13	8	5	partly-cloudy-night	30	0.002	
12/10/2017 0:00	17	11	6	partly-cloudy-night	30	0.0015	
12/10/2017 1:00	13	7	6	partly-cloudy-night	30	0.0009	
12/10/2017 2:00	8	6	2	partly-cloudy-night	31	0.0005	
12/10/2017 3:00	5	3	2	partly-cloudy-night	30	0.0003	
12/10/2017 4:00	3	0	3	clear-night	29	0	
12/10/2017 5:00	5	4	1	clear-night	29	0	
12/10/2017 6:00	20	15	5	clear-night	28	0	
12/10/2017 7:00	78	41	37	clear-night	28	0	
12/10/2017 8:00	133	64	69	clear-day	28	0.0001	
12/10/2017 9:00	555	360	195	clear-day	30	0.0002	
12/10/2017 10:00	1060	581	479	clear-day	32	0.0026	
12/10/2017 11:00	1767	866	901	clear-day	35	0.0109	
12/10/2017 12:00	2043	907	1136	clear-day	37	0.0195	
12/10/2017 13:00	2239	1014	1225	clear-day	38	0.0241	
12/10/2017 14:00	2239	1012	1227	rain	38	0.0254	
12/10/2017 15:00	2210	1148	1062	partly-cloudy-day	38	0.0195	
12/10/2017 16:00	1775	832	943	partly-cloudy-day	37	0.0111	
12/10/2017 17:00	539	221	318	partly-cloudy-night	36	0.0043	
12/10/2017 18:00	319	176	143	partly-cloudy-night	36	0.0022	
12/10/2017 19:00	270	156	114	clear-night	35	0.0008	
12/10/2017 20:00	220	135	85	clear-night	35	0.0003	
12/10/2017 21:00	122	76	46	clear-night	35	0.0001	
12/10/2017 22:00	61	27	34	partly-cloudy-night	35	0.0001	
12/10/2017 23:00	62	30	32	partly-cloudy-night	35	0.0001	
12/11/2017 0:00	19	7	12	partly-cloudy-night	34	0.0002	
12/11/2017 1:00	9	6	3	cloudy	34	0.0001	
12/11/2017 2:00	3	2	1	cloudy	34	0.0001	
12/11/2017 3:00	5	2	3	partly-cloudy-night	34	0.0001	
12/11/2017 4:00	6	4	2	partly-cloudy-night	34	0	
12/11/2017 5:00	14	8	6	partly-cloudy-night	34	0.0002	
12/11/2017 6:00	57	27	30	partly-cloudy-night	33	0	
12/11/2017 7:00	103	37	66	partly-cloudy-night	32	0	
12/11/2017 8:00	248	86	162	partly-cloudy-day	32	0.0007	
12/11/2017 9:00	445	198	247	clear-day	34	0	
12/11/2017 10:00	757	414	343	clear-day	36	0.0022	
12/11/2017 11:00	1264	644	620	clear-day	38	0.0018	
12/11/2017 12:00	1414	599	815	clear-day	39	0.0035	
12/11/2017 13:00	1572	651	921	clear-day	40	0.0045	
12/11/2017 14:00	1674	792	882	partly-cloudy-day	40	0.0042	
12/11/2017 15:00	1728	840	888	clear-day	40	0.0043	
12/11/2017 16:00	1376	626	750	clear-day	39	0.0016	
12/11/2017 17:00	965	484	481	clear-night	38	0.0007	
12/11/2017 18:00	576	366	210	clear-night	37	0.0003	
12/11/2017 19:00	433	335	98	clear-night	36	0	
12/11/2017 20:00	329	236	93	clear-night	35	0	
12/11/2017 21:00	113	63	50	partly-cloudy-night	36	0.0001	
12/11/2017 22:00	127	39	88	partly-cloudy-night	36	0.0007	
12/11/2017 23:00	131	30	101	cloudy	36	0	
12/12/2017 0:00	27	16	11	partly-cloudy-night	37	0	
12/12/2017 1:00	19	6	13	partly-cloudy-night	37	0	
12/12/2017 2:00	18	8	10	partly-cloudy-night	38	0	
12/12/2017 3:00	10	6	4	partly-cloudy-night	39	0.0002	
12/12/2017 4:00	5	2	3	partly-cloudy-night	41	0.0004	
12/12/2017 5:00	23	14	9	partly-cloudy-night	42	0.0005	
12/12/2017 6:00	62	34	28	partly-cloudy-night	43	0.0014	
12/12/2017 7:00	140	59	81	partly-cloudy-night	44	0.0025	
12/12/2017 8:00	256	77	179	partly-cloudy-day	45	0.0025	
12/12/2017 9:00	263	126	137	partly-cloudy-day	46	0.0031	
12/12/2017 10:00	588	308	280	partly-cloudy-day	48	0.0022	
12/12/2017 11:00	953	469	484	partly-cloudy-day	48	0.0018	
12/12/2017 12:00	1001	431	570	partly-cloudy-day	47	0.0019	
12/12/2017 13:00	904	432	472	partly-cloudy-day	46	0.0021	
12/12/2017 14:00	935	414	521	partly-cloudy-day	45	0.0019	
12/12/2017 15:00	915	431	484	partly-cloudy-day	44	0.0012	
12/12/2017 16:00	731	388	343	partly-cloudy-day	43	0.0002	
12/12/2017 17:00	619	424	195	partly-cloudy-night	42	0.0003	
12/12/2017 18:00	420	297	123	partly-cloudy-night	41	0.0008	
12/12/2017 19:00	326	234	92	partly-cloudy-night	40	0	
12/12/2017 20:00	277	223	54	partly-cloudy-night	36	0.0008	
12/12/2017 21:00	146	106	40	partly-cloudy-night	34	0.0003	
12/12/2017 22:00	84	65	19	partly-cloudy-night	33	0	
12/12/2017 23:00	23	8	15	partly-cloudy-night	31	0.0001	
12/13/2017 0:00	20	10	10	partly-cloudy-night	29	0	
12/13/2017 1:00	13	8	5	partly-cloudy-night	27	0	
12/13/2017 2:00	5	3	2	partly-cloudy-night	24	0.0001	
12/13/2017 3:00	5	4	1	clear-night	23	0	
12/13/2017 4:00	1	0	1	clear-night	21	0	
12/13/2017 5:00	16	6	10	clear-night	21	0	
12/13/2017 6:00	85	43	42	clear-night	20	0	
12/13/2017 7:00	94	48	46	clear-night	20	0	
12/13/2017 8:00	146	45	101	clear-day	21	0	
12/13/2017 9:00	250	97	153	partly-cloudy-day	22	0.0007	
12/13/2017 10:00	463	230	233	partly-cloudy-day	24	0.0001	
12/13/2017 11:00	666	323	343	partly-cloudy-day	25	0	
12/13/2017 12:00	701	310	391	partly-cloudy-day	27	0.0004	
12/13/2017 13:00	647	288	359	partly-cloudy-day	29	0.0001	
12/13/2017 14:00	809	373	436	clear-day	30	0	
12/13/2017 15:00	966	439	527	clear-day	30	0	
12/13/2017 16:00	744	340	404	clear-day	30	0	
12/13/2017 17:00	549	323	226	clear-night	28	0.0003	
12/13/2017 18:00	387	285	102	clear-night	28	0	
12/13/2017 19:00	183	128	55	clear-night	27	0	
12/13/2017 20:00	163	132	31	clear-night	27	0	
12/13/2017 21:00	156	138	18	partly-cloudy-night	26	0	
12/13/2017 22:00	149	124	25	partly-cloudy-night	26	0	
12/13/2017 23:00	85	80	5	partly-cloudy-night	27	0	
12/14/2017 0:00	12	5	7	partly-cloudy-night	25	0.0002	
12/14/2017 1:00	12	7	5	partly-cloudy-night	23	0.0005	
12/14/2017 2:00	4	1	3	partly-cloudy-night	23	0.0022	
12/14/2017 3:00	4	2	2	partly-cloudy-night	24	0.0021	
12/14/2017 4:00	1	0	1	partly-cloudy-night	25	0.0004	
12/14/2017 5:00	6	4	2	partly-cloudy-night	25	0	
12/14/2017 6:00	29	15	14	partly-cloudy-night	25	0.0001	
12/14/2017 7:00	77	26	51	fog	25	0.0007	
12/14/2017 8:00	127	40	87	fog	25	0.0018	
12/14/2017 9:00	184	80	104	partly-cloudy-day	26	0.0007	
12/14/2017 10:00	435	257	178	partly-cloudy-day	27	0.0001	
12/14/2017 11:00	687	322	365	partly-cloudy-day	28	0.0022	
12/14/2017 12:00	815	359	456	partly-cloudy-day	30	0.0068	
12/14/2017 13:00	954	402	552	clear-day	31	0.006	
12/14/2017 14:00	1090	495	595	partly-cloudy-day	31	0.0033	
12/14/2017 15:00	936	449	487	partly-cloudy-day	31	0.0012	
12/14/2017 16:00	883	414	469	clear-day	29	0.0002	
12/14/2017 17:00	405	212	193	clear-night	28	0	
12/14/2017 18:00	214	111	103	clear-night	27	0	
12/14/2017 19:00	165	82	83	clear-night	26	0	
12/14/2017 20:00	115	82	33	clear-night	25	0	
12/14/2017 21:00	73	53	20	clear-night	24	0	
12/14/2017 22:00	82	72	10	clear-night	23	0	
12/14/2017 23:00	95	83	12	clear-night	22	0	
12/15/2017 0:00	103	97	6	clear-night	21	0	
12/15/2017 1:00	81	79	2	clear-night	21	0	
12/15/2017 2:00	8	7	1	clear-night	20	0	
12/15/2017 3:00	1	0	1	clear-night	20	0	
12/15/2017 4:00	0	0	0	clear-night	19	0	
12/15/2017 5:00	6	1	5	clear-night	19	0	
12/15/2017 6:00	35	16	19	clear-night	18	0	
12/15/2017 7:00	90	34	56	clear-night	19	0	
12/15/2017 8:00	159	51	108	clear-day	21	0	
12/15/2017 9:00	232	105	127	clear-day	22	0	
12/15/2017 10:00	490	233	257	snow	24	0.0162	
12/15/2017 11:00	826	386	440	clear-day	25	0	
12/15/2017 12:00	943	396	547	clear-day	26	0	
12/15/2017 13:00	1115	491	624	partly-cloudy-day	26	0	
12/15/2017 14:00	1260	549	711	partly-cloudy-day	27	0	
12/15/2017 15:00	796	332	464	partly-cloudy-day	26	0.0001	
12/15/2017 16:00	533	250	283	fog	24	0.0008	
12/15/2017 17:00	255	150	105	fog	23	0.0024	
12/15/2017 18:00	155	103	52	partly-cloudy-night	23	0.0035	
12/15/2017 19:00	77	44	33	partly-cloudy-night	24	0.0015	
12/15/2017 20:00	73	48	25	partly-cloudy-night	24	0.0006	
12/15/2017 21:00	42	27	15	partly-cloudy-night	24	0.0004	
12/15/2017 22:00	25	13	12	partly-cloudy-night	22	0.0002	
12/15/2017 23:00	38	29	9	clear-night	22	0.0002	
12/16/2017 0:00	10	8	2	clear-night	22	0	
12/16/2017 1:00	3	2	1	clear-night	21	0	
12/16/2017 2:00	0	0	0	clear-night	21	0	
12/16/2017 3:00	0	0	0	clear-night	23	0	
12/16/2017 4:00	1	0	1	clear-night	23	0	
12/16/2017 5:00	1	0	1	clear-night	23	0	
12/16/2017 6:00	12	8	4	clear-night	23	0	
12/16/2017 7:00	74	43	31	clear-night	24	0	
12/16/2017 8:00	126	60	66	clear-day	25	0	
12/16/2017 9:00	431	236	195	clear-day	27	0	
12/16/2017 10:00	892	528	364	partly-cloudy-day	30	0.0006	
12/16/2017 11:00	1437	722	715	partly-cloudy-day	32	0.0026	
12/16/2017 12:00	1654	782	872	partly-cloudy-day	34	0.0031	
12/16/2017 13:00	1932	815	1117	partly-cloudy-day	36	0.0056	
12/16/2017 14:00	1857	881	976	partly-cloudy-day	36	0.0085	
12/16/2017 15:00	1741	868	873	partly-cloudy-day	36	0.0053	
12/16/2017 16:00	1432	632	800	cloudy	37	0.0026	
12/16/2017 17:00	607	322	285	cloudy	37	0.002	
12/16/2017 18:00	361	186	175	cloudy	37	0.0018	
12/16/2017 19:00	296	175	121	cloudy	37	0.0017	
12/16/2017 20:00	247	157	90	partly-cloudy-night	37	0.001	
12/16/2017 21:00	203	141	62	partly-cloudy-night	36	0.0011	
12/16/2017 22:00	161	115	46	partly-cloudy-night	35	0.0005	
12/16/2017 23:00	145	112	33	partly-cloudy-night	34	0.0006	
12/17/2017 0:00	123	114	9	partly-cloudy-night	34	0.0001	
12/17/2017 1:00	103	95	8	partly-cloudy-night	33	0	
12/17/2017 2:00	12	6	6	partly-cloudy-night	33	0	
12/17/2017 3:00	7	3	4	partly-cloudy-night	33	0	
12/17/2017 4:00	2	1	1	partly-cloudy-night	33	0	
12/17/2017 5:00	7	4	3	partly-cloudy-night	32	0	
12/17/2017 6:00	32	22	10	partly-cloudy-night	32	0.0001	
12/17/2017 7:00	92	48	44	partly-cloudy-night	32	0	
12/17/2017 8:00	147	66	81	partly-cloudy-day	32	0	
12/17/2017 9:00	459	276	183	partly-cloudy-day	33	0	
12/17/2017 10:00	811	452	359	cloudy	34	0.0001	
12/17/2017 11:00	1280	611	669	cloudy	34	0.0001	
12/17/2017 12:00	1441	674	767	cloudy	35	0.0004	
12/17/2017 13:00	1860	876	984	partly-cloudy-day	36	0.0015	
12/17/2017 14:00	1828	910	918	clear-day	36	0.0028	
12/17/2017 15:00	1995	983	1012	clear-day	37	0.0019	
12/17/2017 16:00	1735	728	1007	clear-day	36	0.001	
12/17/2017 17:00	964	483	481	clear-night	35	0.0002	
12/17/2017 18:00	609	300	309	clear-night	35	0.0001	
12/17/2017 19:00	455	276	179	clear-night	35	0.0003	
12/17/2017 20:00	325	223	102	partly-cloudy-night	35	0	
12/17/2017 21:00	263	149	114	partly-cloudy-night	35	0	
12/17/2017 22:00	168	99	69	partly-cloudy-night	35	0	
12/17/2017 23:00	48	19	29	partly-cloudy-night	34	0	
12/18/2017 0:00	42	16	26	partly-cloudy-night	34	0	
12/18/2017 1:00	7	3	4	cloudy	34	0	
12/18/2017 2:00	2	1	1	cloudy	34	0.0005	
12/18/2017 3:00	2	1	1	partly-cloudy-night	34	0.0027	
12/18/2017 4:00	2	1	1	partly-cloudy-night	34	0.0028	
12/18/2017 5:00	15	10	5	partly-cloudy-night	34	0.0007	
12/18/2017 6:00	50	29	21	partly-cloudy-night	34	0.0006	
12/18/2017 7:00	129	63	66	partly-cloudy-night	34	0.0004	
12/18/2017 8:00	240	73	167	cloudy	35	0.0004	
12/18/2017 9:00	403	212	191	partly-cloudy-day	36	0.0002	
12/18/2017 10:00	768	418	350	cloudy	37	0.0006	
12/18/2017 11:00	1210	643	567	cloudy	39	0.0012	
12/18/2017 12:00	1518	657	861	partly-cloudy-day	41	0.0015	
12/18/2017 13:00	1678	811	867	partly-cloudy-day	43	0.0011	
12/18/2017 14:00	1826	773	1053	partly-cloudy-day	44	0.0008	
12/18/2017 15:00	1843	851	992	partly-cloudy-day	45	0.0004	
12/18/2017 16:00	1604	702	902	partly-cloudy-day	44	0.0002	
12/18/2017 17:00	1019	513	506	partly-cloudy-night	43	0.0001	
12/18/2017 18:00	606	372	234	cloudy	43	0.0003	
12/18/2017 19:00	465	296	169	partly-cloudy-night	44	0.0002	
12/18/2017 20:00	313	222	91	partly-cloudy-night	44	0.0001	
12/18/2017 21:00	205	129	76	partly-cloudy-night	44	0.0001	
12/18/2017 22:00	120	64	56	partly-cloudy-night	43	0	
12/18/2017 23:00	63	37	26	partly-cloudy-night	43	0.0001	
12/19/2017 0:00	40	25	15	partly-cloudy-night	43	0	
12/19/2017 1:00	22	12	10	cloudy	44	0.0003	
12/19/2017 2:00	6	2	4	cloudy	44	0.0001	
12/19/2017 3:00	6	0	6	cloudy	44	0.0001	
12/19/2017 4:00	6	4	2	cloudy	44	0	
12/19/2017 5:00	30	19	11	cloudy	43	0	
12/19/2017 6:00	86	49	37	cloudy	43	0	
12/19/2017 7:00	147	53	94	cloudy	44	0	
12/19/2017 8:00	276	110	166	partly-cloudy-day	45	0	
12/19/2017 9:00	483	231	252	partly-cloudy-day	46	0	
12/19/2017 10:00	773	426	347	partly-cloudy-day	49	0	
12/19/2017 11:00	1257	603	654	partly-cloudy-day	52	0.0001	
12/19/2017 12:00	1534	722	812	partly-cloudy-day	52	0.0001	
12/19/2017 13:00	1649	709	940	partly-cloudy-day	54	0	
12/19/2017 14:00	1694	780	914	clear-day	54	0	
12/19/2017 15:00	1818	864	954	clear-day	54	0	
12/19/2017 16:00	1634	724	910	clear-day	54	0.0001	
12/19/2017 17:00	963	487	476	clear-night	53	0	
12/19/2017 18:00	590	358	232	clear-night	52	0	
12/19/2017 19:00	398	273	125	clear-night	51	0	
12/19/2017 20:00	345	230	115	clear-night	51	0	
12/19/2017 21:00	219	163	56	clear-night	50	0	
12/19/2017 22:00	217	152	65	clear-night	49	0	
12/19/2017 23:00	150	121	29	clear-night	48	0	
12/20/2017 0:00	125	105	20	clear-night	48	0	
12/20/2017 1:00	19	15	4	clear-night	49	0.0001	
12/20/2017 2:00	10	9	1	clear-night	49	0	
12/20/2017 3:00	5	4	1	partly-cloudy-night	48	0	
12/20/2017 4:00	4	3	1	partly-cloudy-night	47	0	
12/20/2017 5:00	20	10	10	clear-night	47	0	
12/20/2017 6:00	45	24	21	clear-night	45	0	
12/20/2017 7:00	136	58	78	clear-night	43	0	
12/20/2017 8:00	254	89	165	clear-day	42	0	
12/20/2017 9:00	335	161	174	clear-day	42	0	
12/20/2017 10:00	651	374	277	partly-cloudy-day	43	0	
12/20/2017 11:00	1143	566	577	partly-cloudy-day	43	0	
12/20/2017 12:00	1374	612	762	partly-cloudy-day	43	0	
12/20/2017 13:00	1313	571	742	clear-day	43	0	
12/20/2017 14:00	1371	619	752	clear-day	43	0	
12/20/2017 15:00	1607	842	765	clear-day	43	0	
12/20/2017 16:00	1481	699	782	clear-day	43	0	
12/20/2017 17:00	877	436	441	clear-night	41	0	
12/20/2017 18:00	394	235	159	clear-night	39	0	
12/20/2017 19:00	256	154	102	clear-night	37	0	
12/20/2017 20:00	260	193	67	clear-night	36	0	
12/20/2017 21:00	211	146	65	clear-night	35	0	
12/20/2017 22:00	111	90	21	clear-night	34	0	
12/20/2017 23:00	116	84	32	clear-night	34	0	
12/21/2017 0:00	17	10	7	clear-night	33	0	
12/21/2017 1:00	10	7	3	clear-night	32	0	
12/21/2017 2:00	6	5	1	clear-night	31	0.0009	
12/21/2017 3:00	7	4	3	clear-night	31	0	
12/21/2017 4:00	2	1	1	clear-night	30	0	
12/21/2017 5:00	12	5	7	clear-night	30	0	
12/21/2017 6:00	51	28	23	clear-night	31	0	
12/21/2017 7:00	145	71	74	clear-night	31	0	
12/21/2017 8:00	189	81	108	clear-day	31	0	
12/21/2017 9:00	370	188	182	clear-day	34	0	
12/21/2017 10:00	752	417	335	clear-day	35	0	
12/21/2017 11:00	1174	539	635	clear-day	36	0	
12/21/2017 12:00	1361	561	800	clear-day	37	0.0001	
12/21/2017 13:00	1480	596	884	clear-day	38	0.0002	
12/21/2017 14:00	1567	669	898	clear-day	39	0	
12/21/2017 15:00	1805	880	925	clear-day	39	0	
12/21/2017 16:00	1739	791	948	clear-day	39	0	
12/21/2017 17:00	1052	505	547	clear-night	38	0	
12/21/2017 18:00	580	348	232	clear-night	37	0	
12/21/2017 19:00	368	264	104	partly-cloudy-night	36	0	
12/21/2017 20:00	307	235	72	clear-night	36	0.0006	
12/21/2017 21:00	225	171	54	clear-night	36	0	
12/21/2017 22:00	168	126	42	clear-night	34	0	
12/21/2017 23:00	140	129	11	partly-cloudy-night	34	0	
12/22/2017 0:00	187	176	11	partly-cloudy-night	34	0	
12/22/2017 1:00	14	8	6	clear-night	34	0.0001	
12/22/2017 2:00	7	6	1	clear-night	34	0	
12/22/2017 3:00	2	0	2	clear-night	34	0	
12/22/2017 4:00	1	0	1	partly-cloudy-night	34	0	
12/22/2017 5:00	13	5	8	partly-cloudy-night	34	0	
12/22/2017 6:00	36	20	16	partly-cloudy-night	35	0	
12/22/2017 7:00	102	49	53	partly-cloudy-night	35	0	
12/22/2017 8:00	195	96	99	partly-cloudy-day	35	0	
12/22/2017 9:00	321	169	152	partly-cloudy-day	36	0	
12/22/2017 10:00	657	359	298	partly-cloudy-day	38	0	
12/22/2017 11:00	1224	666	558	partly-cloudy-day	39	0	
12/22/2017 12:00	1608	751	857	partly-cloudy-day	41	0	
12/22/2017 13:00	1668	800	868	partly-cloudy-day	43	0	
12/22/2017 14:00	1772	824	948	partly-cloudy-day	45	0	
12/22/2017 15:00	1825	914	911	partly-cloudy-day	45	0	
12/22/2017 16:00	1607	802	805	partly-cloudy-day	46	0	
12/22/2017 17:00	970	480	490	partly-cloudy-night	45	0	
12/22/2017 18:00	533	279	254	partly-cloudy-night	45	0	
12/22/2017 19:00	345	183	162	partly-cloudy-night	44	0	
12/22/2017 20:00	233	107	126	partly-cloudy-night	43	0	
12/22/2017 21:00	171	83	88	clear-night	42	0	
12/22/2017 22:00	164	92	72	partly-cloudy-night	41	0	
12/22/2017 23:00	184	148	36	cloudy	40	0	
12/23/2017 0:00	32	24	8	partly-cloudy-night	40	0	
12/23/2017 1:00	30	17	13	partly-cloudy-night	40	0	
12/23/2017 2:00	13	9	4	partly-cloudy-night	39	0.0011	
12/23/2017 3:00	3	0	3	partly-cloudy-night	39	0.0007	
12/23/2017 4:00	1	0	1	cloudy	39	0	
12/23/2017 5:00	2	1	1	partly-cloudy-night	39	0.0038	
12/23/2017 6:00	5	3	2	partly-cloudy-night	39	0.0146	
12/23/2017 7:00	39	13	26	cloudy	39	0.0205	
12/23/2017 8:00	62	32	30	rain	39	0.026	
12/23/2017 9:00	121	60	61	cloudy	39	0.0234	
12/23/2017 10:00	241	132	109	rain	40	0.0288	
12/23/2017 11:00	263	150	113	rain	40	0.0406	
12/23/2017 12:00	255	145	110	rain	41	0.0506	
12/23/2017 13:00	417	200	217	rain	42	0.0746	
12/23/2017 14:00	755	446	309	rain	45	0.0438	
12/23/2017 15:00	899	472	427	partly-cloudy-day	45	0.0036	
12/23/2017 16:00	922	492	430	partly-cloudy-day	46	0.0006	
12/23/2017 17:00	421	195	226	partly-cloudy-night	47	0.0004	
12/23/2017 18:00	184	60	124	partly-cloudy-night	47	0.0026	
12/23/2017 19:00	60	36	24	rain	46	0.0325	
12/23/2017 20:00	89	42	47	rain	46	0.0279	
12/23/2017 21:00	79	45	34	partly-cloudy-night	45	0.0238	
12/23/2017 22:00	72	35	37	partly-cloudy-night	44	0.0066	
12/23/2017 23:00	115	89	26	partly-cloudy-night	42	0.0013	
12/24/2017 0:00	56	34	22	clear-night	40	0.0004	Christmas Eve
12/24/2017 1:00	17	9	8	clear-night	39	0.0002	Christmas Eve
12/24/2017 2:00	11	5	6	clear-night	38	0.0003	Christmas Eve
12/24/2017 3:00	2	0	2	clear-night	38	0.0002	Christmas Eve
12/24/2017 4:00	0	0	0	clear-night	38	0	Christmas Eve
12/24/2017 5:00	3	0	3	clear-night	37	0	Christmas Eve
12/24/2017 6:00	23	13	10	clear-night	37	0.0002	Christmas Eve
12/24/2017 7:00	95	54	41	clear-night	36	0.0001	Christmas Eve
12/24/2017 8:00	183	84	99	clear-day	36	0	Christmas Eve
12/24/2017 9:00	526	327	199	clear-day	37	0.0001	Christmas Eve
12/24/2017 10:00	1072	593	479	clear-day	38	0.0001	Christmas Eve
12/24/2017 11:00	1802	906	896	clear-day	38	0.0001	Christmas Eve
12/24/2017 12:00	2371	1112	1259	clear-day	39	0	Christmas Eve
12/24/2017 13:00	2348	1130	1218	clear-day	39	0	Christmas Eve
12/24/2017 14:00	2612	1361	1251	clear-day	39	0	Christmas Eve
12/24/2017 15:00	2616	1445	1171	clear-day	39	0	Christmas Eve
12/24/2017 16:00	2487	1282	1205	clear-day	39	0.0001	Christmas Eve
12/24/2017 17:00	1236	574	662	clear-night	38	0.0001	Christmas Eve
12/24/2017 18:00	674	361	313	partly-cloudy-night	38	0	Christmas Eve
12/24/2017 19:00	421	167	254	partly-cloudy-night	38	0	Christmas Eve
12/24/2017 20:00	192	73	119	cloudy	38	0	Christmas Eve
12/24/2017 21:00	131	66	65	cloudy	37	0.0002	Christmas Eve
12/24/2017 22:00	57	20	37	cloudy	36	0.0014	Christmas Eve
12/24/2017 23:00	22	9	13	cloudy	36	0.0029	Christmas Eve
12/25/2017 0:00	6	2	4	cloudy	35	0.0042	Christmas Day
12/25/2017 1:00	5	4	1	cloudy	35	0.0097	Christmas Day
12/25/2017 2:00	9	6	3	cloudy	36	0.0191	Christmas Day
12/25/2017 3:00	0	0	0	cloudy	36	0.0174	Christmas Day
12/25/2017 4:00	1	0	1	cloudy	36	0.0159	Christmas Day
12/25/2017 5:00	2	0	2	partly-cloudy-night	35	0.0189	Christmas Day
12/25/2017 6:00	5	2	3	partly-cloudy-night	34	0.023	Christmas Day
12/25/2017 7:00	50	29	21	rain	34	0.0707	Christmas Day
12/25/2017 8:00	149	68	81	partly-cloudy-day	35	0.0059	Christmas Day
12/25/2017 9:00	479	330	149	clear-day	36	0.0033	Christmas Day
12/25/2017 10:00	1145	682	463	clear-day	36	0.0043	Christmas Day
12/25/2017 11:00	1768	951	817	partly-cloudy-day	35	0.0046	Christmas Day
12/25/2017 12:00	2248	1158	1090	partly-cloudy-day	35	0.0066	Christmas Day
12/25/2017 13:00	2495	1452	1043	partly-cloudy-day	35	0.0071	Christmas Day
12/25/2017 14:00	2715	1610	1105	partly-cloudy-day	35	0.0041	Christmas Day
12/25/2017 15:00	2691	1573	1118	partly-cloudy-day	34	0.001	Christmas Day
12/25/2017 16:00	2640	1435	1205	partly-cloudy-day	34	0.0004	Christmas Day
12/25/2017 17:00	1183	565	618	partly-cloudy-night	32	0.0001	Christmas Day
12/25/2017 18:00	547	234	313	clear-night	31	0.0003	Christmas Day
12/25/2017 19:00	282	156	126	clear-night	31	0.0001	Christmas Day
12/25/2017 20:00	180	89	91	clear-night	29	0	Christmas Day
12/25/2017 21:00	90	47	43	clear-night	28	0.0001	Christmas Day
12/25/2017 22:00	75	27	48	clear-night	28	0	Christmas Day
12/25/2017 23:00	31	14	17	clear-night	27	0	Christmas Day
12/26/2017 0:00	11	4	7	clear-night	27	0	
12/26/2017 1:00	1	0	1	clear-night	27	0	
12/26/2017 2:00	3	1	2	clear-night	26	0	
12/26/2017 3:00	0	0	0	clear-night	26	0	
12/26/2017 4:00	2	0	2	clear-night	25	0	
12/26/2017 5:00	9	4	5	clear-night	24	0	
12/26/2017 6:00	17	8	9	clear-night	24	0	
12/26/2017 7:00	106	54	52	clear-night	24	0	
12/26/2017 8:00	208	88	120	clear-day	24	0	
12/26/2017 9:00	364	221	143	clear-day	24	0	
12/26/2017 10:00	1062	576	486	clear-day	24	0.0001	
12/26/2017 11:00	1689	807	882	clear-day	25	0.0005	
12/26/2017 12:00	1856	840	1016	clear-day	25	0.0003	
12/26/2017 13:00	2031	936	1095	clear-day	26	0	
12/26/2017 14:00	2070	1040	1030	clear-day	27	0	
12/26/2017 15:00	2575	1209	1366	clear-day	28	0.0001	
12/26/2017 16:00	2623	1220	1403	clear-day	27	0.0008	
12/26/2017 17:00	1249	539	710	clear-night	26	0	
12/26/2017 18:00	619	307	312	clear-night	25	0	
12/26/2017 19:00	332	158	174	clear-night	24	0	
12/26/2017 20:00	199	73	126	clear-night	23	0	
12/26/2017 21:00	114	56	58	clear-night	23	0	
12/26/2017 22:00	103	52	51	clear-night	22	0	
12/26/2017 23:00	43	20	23	clear-night	22	0	
12/27/2017 0:00	12	7	5	clear-night	21	0	
12/27/2017 1:00	14	8	6	clear-night	21	0	
12/27/2017 2:00	1	0	1	clear-night	20	0	
12/27/2017 3:00	3	2	1	partly-cloudy-night	20	0	
12/27/2017 4:00	1	0	1	partly-cloudy-night	20	0	
12/27/2017 5:00	6	2	4	cloudy	19	0	
12/27/2017 6:00	61	35	26	cloudy	19	0	
12/27/2017 7:00	129	72	57	cloudy	19	0	
12/27/2017 8:00	224	98	126	partly-cloudy-day	18	0	
12/27/2017 9:00	517	297	220	partly-cloudy-day	19	0	
12/27/2017 10:00	1207	676	531	partly-cloudy-day	20	0	
12/27/2017 11:00	1793	945	848	clear-day	21	0	
12/27/2017 12:00	2115	1016	1099	clear-day	22	0	
12/27/2017 13:00	2320	1079	1241	clear-day	23	0	
12/27/2017 14:00	2185	1063	1122	clear-day	24	0	
12/27/2017 15:00	2588	1399	1189	clear-day	24	0	
12/27/2017 16:00	2701	1375	1326	clear-day	23	0	
12/27/2017 17:00	1296	553	743	clear-night	22	0	
12/27/2017 18:00	669	360	309	clear-night	21	0	
12/27/2017 19:00	305	143	162	clear-night	20	0	
12/27/2017 20:00	132	58	74	clear-night	19	0	
12/27/2017 21:00	69	28	41	clear-night	18	0	
12/27/2017 22:00	54	34	20	clear-night	17	0	
12/27/2017 23:00	41	16	25	clear-night	17	0	
12/28/2017 0:00	16	5	11	clear-night	17	0	
12/28/2017 1:00	3	2	1	clear-night	16	0	
12/28/2017 2:00	2	1	1	clear-night	15	0	
12/28/2017 3:00	2	1	1	clear-night	15	0	
12/28/2017 4:00	2	1	1	clear-night	14	0	
12/28/2017 5:00	6	3	3	clear-night	14	0	
12/28/2017 6:00	16	15	1	clear-night	14	0	
12/28/2017 7:00	73	31	42	clear-night	13	0	
12/28/2017 8:00	154	73	81	clear-day	12	0	
12/28/2017 9:00	422	247	175	clear-day	13	0.0001	
12/28/2017 10:00	1222	710	512	clear-day	14	0.0014	
12/28/2017 11:00	1784	896	888	clear-day	15	0.0013	
12/28/2017 12:00	1763	918	845	clear-day	16	0	
12/28/2017 13:00	2005	937	1068	clear-day	17	0.0007	
12/28/2017 14:00	2020	918	1102	clear-day	17	0	
12/28/2017 15:00	2028	1069	959	clear-day	18	0	
12/28/2017 16:00	2106	994	1112	clear-day	17	0.002	
12/28/2017 17:00	1123	540	583	clear-night	17	0	
12/28/2017 18:00	561	300	261	clear-night	16	0.0009	
12/28/2017 19:00	236	123	113	clear-night	15	0	
12/28/2017 20:00	143	64	79	clear-night	14	0	
12/28/2017 21:00	59	26	33	clear-night	13	0	
12/28/2017 22:00	25	11	14	clear-night	12	0	
12/28/2017 23:00	32	15	17	clear-night	11	0	
12/29/2017 0:00	9	4	5	clear-night	11	0	
12/29/2017 1:00	8	6	2	clear-night	11	0	
12/29/2017 2:00	5	1	4	clear-night	11	0	
12/29/2017 3:00	0	0	0	clear-night	11	0	
12/29/2017 4:00	2	0	2	partly-cloudy-night	11	0	
12/29/2017 5:00	2	0	2	partly-cloudy-night	11	0	
12/29/2017 6:00	16	10	6	partly-cloudy-night	12	0	
12/29/2017 7:00	111	56	55	partly-cloudy-night	12	0	
12/29/2017 8:00	142	68	74	partly-cloudy-day	12	0	
12/29/2017 9:00	442	260	182	partly-cloudy-day	14	0	
12/29/2017 10:00	1020	622	398	clear-day	15	0.0015	
12/29/2017 11:00	1838	939	899	clear-day	17	0.0005	
12/29/2017 12:00	2144	1171	973	clear-day	19	0.0007	
12/29/2017 13:00	2428	1100	1328	clear-day	20	0.0007	
12/29/2017 14:00	2305	1254	1051	partly-cloudy-day	21	0	
12/29/2017 15:00	2424	1331	1093	clear-day	21	0	
12/29/2017 16:00	2366	1166	1200	clear-day	21	0	
12/29/2017 17:00	1215	482	733	clear-night	20	0.0025	
12/29/2017 18:00	564	247	317	clear-night	19	0.0015	
12/29/2017 19:00	247	111	136	clear-night	18	0	
12/29/2017 20:00	200	95	105	clear-night	18	0	
12/29/2017 21:00	119	58	61	clear-night	17	0.0014	
12/29/2017 22:00	56	27	29	clear-night	16	0	
12/29/2017 23:00	126	110	16	clear-night	16	0	
12/30/2017 0:00	16	6	10	clear-night	16	0	
12/30/2017 1:00	6	2	4	clear-night	16	0	
12/30/2017 2:00	4	0	4	clear-night	16	0	
12/30/2017 3:00	0	0	0	clear-night	16	0	
12/30/2017 4:00	0	0	0	partly-cloudy-night	16	0	
12/30/2017 5:00	2	1	1	partly-cloudy-night	16	0	
12/30/2017 6:00	11	8	3	partly-cloudy-night	17	0	
12/30/2017 7:00	78	38	40	cloudy	18	0	
12/30/2017 8:00	134	67	67	partly-cloudy-day	18	0	
12/30/2017 9:00	391	227	164	partly-cloudy-day	19	0	
12/30/2017 10:00	916	450	466	partly-cloudy-day	19	0.0005	
12/30/2017 11:00	1185	634	551	partly-cloudy-day	19	0.0004	
12/30/2017 12:00	1321	726	595	fog	19	0.0011	
12/30/2017 13:00	1577	822	755	partly-cloudy-day	20	0.0009	
12/30/2017 14:00	1816	1026	790	partly-cloudy-day	21	0.0008	
12/30/2017 15:00	2021	1126	895	partly-cloudy-day	22	0.0003	
12/30/2017 16:00	2164	1203	961	partly-cloudy-day	22	0	
12/30/2017 17:00	655	337	318	partly-cloudy-night	21	0	
12/30/2017 18:00	358	203	155	clear-night	20	0	
12/30/2017 19:00	204	128	76	clear-night	20	0	
12/30/2017 20:00	173	90	83	clear-night	20	0	
12/30/2017 21:00	126	48	78	clear-night	20	0	
12/30/2017 22:00	43	20	23	partly-cloudy-night	20	0.0001	
12/30/2017 23:00	57	30	27	partly-cloudy-night	20	0.0025	
12/31/2017 0:00	12	2	10	clear-night	19	0.0015	New Year's Eve
12/31/2017 1:00	12	4	8	clear-night	18	0	New Year's Eve
12/31/2017 2:00	4	3	1	partly-cloudy-night	18	0	New Year's Eve
12/31/2017 3:00	0	0	0	clear-night	18	0	New Year's Eve
12/31/2017 4:00	0	0	0	clear-night	17	0	New Year's Eve
12/31/2017 5:00	2	1	1	clear-night	16	0	New Year's Eve
12/31/2017 6:00	7	5	2	clear-night	16	0	New Year's Eve
12/31/2017 7:00	46	28	18	clear-night	14	0	New Year's Eve
12/31/2017 8:00	103	67	36	clear-day	13	0	New Year's Eve
12/31/2017 9:00	401	288	113	clear-day	13	0	New Year's Eve
12/31/2017 10:00	988	536	452	clear-day	14	0	New Year's Eve
12/31/2017 11:00	1493	825	668	clear-day	15	0	New Year's Eve
12/31/2017 12:00	1964	890	1074	clear-day	15	0	New Year's Eve
12/31/2017 13:00	1924	911	1013	clear-day	15	0	New Year's Eve
12/31/2017 14:00	1826	900	926	clear-day	15	0	New Year's Eve
12/31/2017 15:00	1724	915	809	partly-cloudy-day	14	0	New Year's Eve
12/31/2017 16:00	1589	741	848	clear-day	14	0	New Year's Eve
12/31/2017 17:00	831	354	477	clear-night	13	0	New Year's Eve
12/31/2017 18:00	334	169	165	clear-night	12	0	New Year's Eve
12/31/2017 19:00	241	116	125	clear-night	11	0	New Year's Eve
12/31/2017 20:00	184	94	90	clear-night	11	0	New Year's Eve
12/31/2017 21:00	172	94	78	clear-night	10	0	New Year's Eve
12/31/2017 22:00	404	301	103	clear-night	9	0	New Year's Eve
12/31/2017 23:00	1402	1375	27	clear-night	9	0	New Year's Eve
1/1/2018 0:00	1328	163	1165	clear-night	9	0	New Year's Day
1/1/2018 1:00	29	9	20	clear-night	8	0	New Year's Day
1/1/2018 2:00	16	7	9	clear-night	8	0	New Year's Day
1/1/2018 3:00	4	1	3	clear-night	7	0	New Year's Day
1/1/2018 4:00	5	0	5	clear-night	7	0	New Year's Day
1/1/2018 5:00	2	1	1	clear-night	7	0	New Year's Day
1/1/2018 6:00	14	13	1	clear-night	6	0	New Year's Day
1/1/2018 7:00	87	35	52	clear-night	6	0	New Year's Day
1/1/2018 8:00	58	28	30	clear-day	6	0	New Year's Day
1/1/2018 9:00	174	107	67	clear-day	8	0	New Year's Day
1/1/2018 10:00	484	317	167	clear-day	11	0	New Year's Day
1/1/2018 11:00	1046	618	428	clear-day	12	0	New Year's Day
1/1/2018 12:00	1504	880	624	clear-day	15	0	New Year's Day
1/1/2018 13:00	1900	1033	867	clear-day	16	0	New Year's Day
1/1/2018 14:00	2066	1125	941	clear-day	17	0	New Year's Day
1/1/2018 15:00	2325	1386	939	clear-day	18	0	New Year's Day
1/1/2018 16:00	2629	1527	1102	clear-day	18	0	New Year's Day
1/1/2018 17:00	1428	661	767	clear-night	17	0	New Year's Day
1/1/2018 18:00	585	230	355	clear-night	17	0	New Year's Day
1/1/2018 19:00	336	146	190	clear-night	16	0	New Year's Day
1/1/2018 20:00	154	54	100	clear-night	15	0	New Year's Day
1/1/2018 21:00	118	47	71	clear-night	15	0	New Year's Day
1/1/2018 22:00	97	36	61	clear-night	15	0	New Year's Day
1/1/2018 23:00	56	18	38	clear-night	15	0	New Year's Day
1/2/2018 0:00	15	2	13	clear-night	14	0	
1/2/2018 1:00	2	0	2	clear-night	14	0	
1/2/2018 2:00	9	3	6	clear-night	14	0	
1/2/2018 3:00	0	0	0	clear-night	13	0	
1/2/2018 4:00	1	0	1	clear-night	13	0	
1/2/2018 5:00	1	0	1	clear-night	13	0	
1/2/2018 6:00	20	10	10	clear-night	12	0	
1/2/2018 7:00	86	42	44	clear-night	12	0	
1/2/2018 8:00	162	82	80	clear-day	12	0	
1/2/2018 9:00	403	243	160	clear-day	14	0	
1/2/2018 10:00	1004	626	378	clear-day	16	0	
1/2/2018 11:00	1593	783	810	clear-day	19	0	
1/2/2018 12:00	1750	836	914	clear-day	21	0	
1/2/2018 13:00	1969	947	1022	clear-day	23	0	
1/2/2018 14:00	2250	1076	1174	clear-day	25	0	
1/2/2018 15:00	2211	1050	1161	clear-day	25	0.0002	
1/2/2018 16:00	2294	1029	1265	clear-day	25	0	
1/2/2018 17:00	1207	473	734	clear-night	24	0	
1/2/2018 18:00	589	286	303	clear-night	23	0	
1/2/2018 19:00	270	143	127	clear-night	22	0	
1/2/2018 20:00	148	66	82	clear-night	20	0	
1/2/2018 21:00	120	56	64	clear-night	19	0	
1/2/2018 22:00	56	30	26	clear-night	18	0	
1/2/2018 23:00	28	13	15	clear-night	18	0	
1/3/2018 0:00	15	7	8	clear-night	17	0	
1/3/2018 1:00	10	5	5	clear-night	17	0	
1/3/2018 2:00	4	1	3	clear-night	16	0	
1/3/2018 3:00	8	4	4	clear-night	15	0	
1/3/2018 4:00	3	1	2	clear-night	15	0	
1/3/2018 5:00	2	1	1	clear-night	14	0	
1/3/2018 6:00	18	12	6	partly-cloudy-night	14	0.0001	
1/3/2018 7:00	111	56	55	clear-night	13	0	
1/3/2018 8:00	194	91	103	clear-day	14	0	
1/3/2018 9:00	278	160	118	snow	17	0.0054	
1/3/2018 10:00	793	451	342	clear-day	19	0.0035	
1/3/2018 11:00	1354	695	659	clear-day	22	0.0005	
1/3/2018 12:00	1734	798	936	clear-day	24	0	
1/3/2018 13:00	1995	958	1037	clear-day	26	0.0004	
1/3/2018 14:00	2160	1069	1091	clear-day	28	0.0018	
1/3/2018 15:00	2333	1136	1197	clear-day	28	0.0018	
1/3/2018 16:00	2160	982	1178	clear-day	28	0.0005	
1/3/2018 17:00	1338	551	787	clear-night	26	0.0013	
1/3/2018 18:00	661	340	321	partly-cloudy-night	25	0	
1/3/2018 19:00	390	233	157	clear-night	24	0	
1/3/2018 20:00	292	193	99	clear-night	25	0.0023	
1/3/2018 21:00	89	40	49	clear-night	26	0.0012	
1/3/2018 22:00	116	63	53	partly-cloudy-night	26	0.0001	
1/3/2018 23:00	105	63	42	partly-cloudy-night	26	0	
1/4/2018 0:00	41	38	3	partly-cloudy-night	26	0.0006	
1/4/2018 1:00	53	51	2	partly-cloudy-night	26	0	
1/4/2018 2:00	6	1	5	partly-cloudy-night	26	0	
1/4/2018 3:00	1	0	1	partly-cloudy-night	27	0	
1/4/2018 4:00	2	0	2	partly-cloudy-night	26	0.0001	
1/4/2018 5:00	8	3	5	partly-cloudy-night	26	0.0011	
1/4/2018 6:00	13	5	8	partly-cloudy-night	25	0.0019	
1/4/2018 7:00	34	12	22	fog	24	0.0038	
1/4/2018 8:00	51	15	36	snow	23	0.0105	
1/4/2018 9:00	48	20	28	snow	22	0.0076	
1/4/2018 10:00	79	42	37	snow	22	0.0088	
1/4/2018 11:00	71	36	35	snow	23	0.0191	
1/4/2018 12:00	126	63	63	snow	23	0.0075	
1/4/2018 13:00	116	59	57	snow	23	0.0122	
1/4/2018 14:00	141	80	61	snow	22	0.0126	
1/4/2018 15:00	199	123	76	snow	22	0.0053	
1/4/2018 16:00	258	155	103	snow	27	0.0114	
1/4/2018 17:00	163	92	71	partly-cloudy-night	24	0.0053	
1/4/2018 18:00	88	39	49	partly-cloudy-night	24	0.0025	
1/4/2018 19:00	34	20	14	partly-cloudy-night	24	0.0018	
1/4/2018 20:00	52	28	24	partly-cloudy-night	23	0.0001	
1/4/2018 21:00	23	11	12	partly-cloudy-night	22	0.0001	
1/4/2018 22:00	8	2	6	partly-cloudy-night	21	0.0003	
1/4/2018 23:00	8	5	3	wind	19	0.0001	
1/5/2018 0:00	8	3	5	partly-cloudy-night	18	0.0002	
1/5/2018 1:00	2	0	2	partly-cloudy-night	16	0.0005	
1/5/2018 2:00	0	0	0	clear-night	15	0.0002	
1/5/2018 3:00	0	0	0	clear-night	13	0.0004	
1/5/2018 4:00	3	1	2	clear-night	12	0.0001	
1/5/2018 5:00	4	2	2	clear-night	11	0	
1/5/2018 6:00	8	6	2	clear-night	10	0	
1/5/2018 7:00	26	10	16	clear-night	9	0	
1/5/2018 8:00	56	19	37	clear-day	9	0	
1/5/2018 9:00	124	67	57	clear-day	9	0	
1/5/2018 10:00	312	174	138	clear-day	11	0	
1/5/2018 11:00	664	304	360	clear-day	12	0	
1/5/2018 12:00	749	361	388	clear-day	13	0	
1/5/2018 13:00	735	337	398	clear-day	14	0.0016	
1/5/2018 14:00	679	350	329	clear-day	15	0.0008	
1/5/2018 15:00	684	341	343	clear-day	15	0.0003	
1/5/2018 16:00	754	352	402	clear-day	15	0.0005	
1/5/2018 17:00	376	150	226	clear-night	15	0	
1/5/2018 18:00	168	75	93	clear-night	14	0	
1/5/2018 19:00	87	46	41	clear-night	14	0.0007	
1/5/2018 20:00	41	19	22	clear-night	13	0	
1/5/2018 21:00	31	15	16	clear-night	11	0	
1/5/2018 22:00	14	7	7	clear-night	11	0.0005	
1/5/2018 23:00	14	7	7	clear-night	10	0.0003	
1/6/2018 0:00	5	2	3	clear-night	9	0.0003	
1/6/2018 1:00	0	0	0	clear-night	9	0	
1/6/2018 2:00	5	1	4	clear-night	9	0	
1/6/2018 3:00	1	0	1	clear-night	9	0	
1/6/2018 4:00	0	0	0	clear-night	8	0	
1/6/2018 5:00	4	1	3	clear-night	8	0	
1/6/2018 6:00	5	3	2	clear-night	8	0	
1/6/2018 7:00	34	21	13	clear-night	7	0	
1/6/2018 8:00	39	16	23	clear-day	7	0	
1/6/2018 9:00	141	97	44	clear-day	8	0	
1/6/2018 10:00	271	170	101	clear-day	9	0	
1/6/2018 11:00	609	348	261	clear-day	11	0.0009	
1/6/2018 12:00	611	313	298	clear-day	12	0	
1/6/2018 13:00	652	341	311	clear-day	12	0	
1/6/2018 14:00	617	302	315	clear-day	13	0	
1/6/2018 15:00	649	314	335	clear-day	13	0	
1/6/2018 16:00	651	342	309	clear-day	12	0	
1/6/2018 17:00	280	118	162	clear-night	11	0	
1/6/2018 18:00	139	60	79	clear-night	10	0	
1/6/2018 19:00	95	28	67	clear-night	9	0	
1/6/2018 20:00	37	23	14	clear-night	8	0	
1/6/2018 21:00	22	2	20	clear-night	8	0	
1/6/2018 22:00	13	1	12	clear-night	7	0	
1/6/2018 23:00	7	3	4	clear-night	6	0	
1/7/2018 0:00	5	3	2	clear-night	6	0	
1/7/2018 1:00	0	0	0	clear-night	6	0	
1/7/2018 2:00	0	0	0	clear-night	5	0	
1/7/2018 3:00	5	3	2	clear-night	5	0	
1/7/2018 4:00	1	0	1	clear-night	5	0	
1/7/2018 5:00	4	2	2	clear-night	4	0	
1/7/2018 6:00	7	3	4	clear-night	4	0	
1/7/2018 7:00	18	6	12	clear-night	4	0	
1/7/2018 8:00	42	20	22	clear-day	4	0	
1/7/2018 9:00	92	54	38	clear-day	6	0	
1/7/2018 10:00	263	173	90	clear-day	9	0	
1/7/2018 11:00	432	250	182	clear-day	11	0	
1/7/2018 12:00	601	331	270	clear-day	13	0.0001	
1/7/2018 13:00	695	328	367	clear-day	15	0	
1/7/2018 14:00	861	445	416	clear-day	17	0.0001	
1/7/2018 15:00	943	458	485	clear-day	18	0.0001	
1/7/2018 16:00	916	431	485	clear-day	17	0	
1/7/2018 17:00	508	213	295	clear-night	17	0	
1/7/2018 18:00	214	101	113	clear-night	16	0	
1/7/2018 19:00	119	60	59	clear-night	17	0	
1/7/2018 20:00	86	40	46	partly-cloudy-night	17	0	
1/7/2018 21:00	36	11	25	partly-cloudy-night	17	0	
1/7/2018 22:00	17	9	8	partly-cloudy-night	16	0	
1/7/2018 23:00	9	5	4	partly-cloudy-night	16	0	
1/8/2018 0:00	1	0	1	partly-cloudy-night	16	0	
1/8/2018 1:00	1	0	1	partly-cloudy-night	17	0	
1/8/2018 2:00	6	3	3	partly-cloudy-night	18	0	
1/8/2018 3:00	3	1	2	partly-cloudy-night	18	0	
1/8/2018 4:00	14	7	7	cloudy	18	0	
1/8/2018 5:00	4	2	2	partly-cloudy-night	18	0	
1/8/2018 6:00	27	12	15	clear-night	18	0	
1/8/2018 7:00	52	17	35	clear-night	18	0	
1/8/2018 8:00	117	39	78	clear-day	19	0.0028	
1/8/2018 9:00	154	56	98	clear-day	20	0	
1/8/2018 10:00	276	163	113	clear-day	22	0	
1/8/2018 11:00	502	268	234	clear-day	24	0	
1/8/2018 12:00	727	330	397	partly-cloudy-day	25	0	
1/8/2018 13:00	656	312	344	partly-cloudy-day	26	0	
1/8/2018 14:00	793	421	372	partly-cloudy-day	28	0	
1/8/2018 15:00	679	338	341	partly-cloudy-day	30	0.0002	
1/8/2018 16:00	577	261	316	partly-cloudy-day	30	0.0028	
1/8/2018 17:00	437	288	149	partly-cloudy-night	28	0.005	
1/8/2018 18:00	290	218	72	partly-cloudy-night	28	0.0057	
1/8/2018 19:00	192	146	46	cloudy	29	0.0029	
1/8/2018 20:00	83	32	51	cloudy	29	0	
1/8/2018 21:00	39	18	21	partly-cloudy-night	29	0	
1/8/2018 22:00	33	11	22	partly-cloudy-night	30	0	
1/8/2018 23:00	18	7	11	cloudy	30	0	
1/9/2018 0:00	11	2	9	cloudy	30	0	
1/9/2018 1:00	3	1	2	cloudy	29	0	
1/9/2018 2:00	3	0	3	partly-cloudy-night	29	0	
1/9/2018 3:00	0	0	0	clear-night	28	0	
1/9/2018 4:00	5	2	3	clear-night	28	0	
1/9/2018 5:00	5	3	2	partly-cloudy-night	29	0	
1/9/2018 6:00	18	8	10	clear-night	29	0	
1/9/2018 7:00	77	34	43	clear-night	29	0	
1/9/2018 8:00	174	47	127	clear-day	30	0	
1/9/2018 9:00	311	186	125	clear-day	32	0.0003	
1/9/2018 10:00	391	209	182	clear-day	37	0.0002	
1/9/2018 11:00	708	368	340	clear-day	40	0.0026	
1/9/2018 12:00	841	437	404	clear-day	42	0.0069	
1/9/2018 13:00	909	388	521	clear-day	43	0.0082	
1/9/2018 14:00	1109	513	596	clear-day	43	0.0079	
1/9/2018 15:00	1175	555	620	clear-day	43	0.0038	
1/9/2018 16:00	1218	573	645	clear-day	42	0.0019	
1/9/2018 17:00	517	202	315	clear-night	40	0.0008	
1/9/2018 18:00	229	139	90	clear-night	38	0.001	
1/9/2018 19:00	151	105	46	clear-night	37	0.0002	
1/9/2018 20:00	77	61	16	clear-night	36	0	
1/9/2018 21:00	44	19	25	clear-night	34	0	
1/9/2018 22:00	29	17	12	clear-night	33	0	
1/9/2018 23:00	14	2	12	clear-night	31	0	
1/10/2018 0:00	8	1	7	clear-night	30	0	
1/10/2018 1:00	4	2	2	clear-night	29	0	
1/10/2018 2:00	7	4	3	clear-night	28	0	
1/10/2018 3:00	3	2	1	clear-night	27	0	
1/10/2018 4:00	2	0	2	clear-night	26	0	
1/10/2018 5:00	9	4	5	clear-night	25	0	
1/10/2018 6:00	27	11	16	clear-night	24	0	
1/10/2018 7:00	115	58	57	clear-night	24	0	
1/10/2018 8:00	181	48	133	clear-day	25	0	
1/10/2018 9:00	260	145	115	clear-day	30	0	
1/10/2018 10:00	412	245	167	clear-day	33	0.0001	
1/10/2018 11:00	745	399	346	clear-day	36	0	
1/10/2018 12:00	872	404	468	clear-day	36	0.0003	
1/10/2018 13:00	885	400	485	clear-day	38	0.0013	
1/10/2018 14:00	828	383	445	clear-day	38	0	
1/10/2018 15:00	1005	470	535	clear-day	39	0.0099	
1/10/2018 16:00	971	444	527	rain	38	0.2259	
1/10/2018 17:00	456	207	249	partly-cloudy-night	36	0.0003	
1/10/2018 18:00	217	117	100	partly-cloudy-night	36	0	
1/10/2018 19:00	139	82	57	partly-cloudy-night	36	0	
1/10/2018 20:00	110	63	47	partly-cloudy-night	37	0	
1/10/2018 21:00	60	37	23	partly-cloudy-night	37	0	
1/10/2018 22:00	83	51	32	cloudy	37	0.0003	
1/10/2018 23:00	48	32	16	partly-cloudy-night	37	0.0003	
1/11/2018 0:00	12	7	5	partly-cloudy-night	36	0	
1/11/2018 1:00	7	4	3	partly-cloudy-night	37	0	
1/11/2018 2:00	4	2	2	partly-cloudy-night	37	0.0001	
1/11/2018 3:00	2	1	1	partly-cloudy-night	36	0	
1/11/2018 4:00	2	0	2	partly-cloudy-night	37	0	
1/11/2018 5:00	10	8	2	partly-cloudy-night	36	0	
1/11/2018 6:00	57	28	29	partly-cloudy-night	36	0	
1/11/2018 7:00	137	60	77	partly-cloudy-night	38	0	
1/11/2018 8:00	187	61	126	partly-cloudy-day	38	0	
1/11/2018 9:00	239	109	130	partly-cloudy-day	40	0.0008	
1/11/2018 10:00	446	256	190	partly-cloudy-day	41	0.0003	
1/11/2018 11:00	755	346	409	partly-cloudy-day	43	0.0005	
1/11/2018 12:00	869	454	415	partly-cloudy-day	46	0.0007	
1/11/2018 13:00	1030	455	575	cloudy	47	0.0004	
1/11/2018 14:00	1040	516	524	cloudy	47	0.0005	
1/11/2018 15:00	1219	595	624	partly-cloudy-day	47	0.0006	
1/11/2018 16:00	1080	511	569	partly-cloudy-day	46	0.0005	
1/11/2018 17:00	701	303	398	partly-cloudy-night	46	0.0003	
1/11/2018 18:00	328	202	126	clear-night	45	0.0002	
1/11/2018 19:00	240	167	73	clear-night	43	0.0002	
1/11/2018 20:00	148	92	56	clear-night	44	0.0002	
1/11/2018 21:00	102	73	29	clear-night	41	0.0002	
1/11/2018 22:00	76	40	36	clear-night	44	0.0002	
1/11/2018 23:00	56	37	19	partly-cloudy-night	43	0.0002	
1/12/2018 0:00	21	10	11	partly-cloudy-night	44	0.0002	
1/12/2018 1:00	5	3	2	partly-cloudy-night	44	0.0002	
1/12/2018 2:00	7	5	2	partly-cloudy-night	44	0.0002	
1/12/2018 3:00	6	2	4	partly-cloudy-night	43	0.0001	
1/12/2018 4:00	3	2	1	partly-cloudy-night	45	0	
1/12/2018 5:00	8	6	2	fog	46	0.0023	
1/12/2018 6:00	30	15	15	partly-cloudy-night	52	0.0053	
1/12/2018 7:00	76	27	49	partly-cloudy-night	53	0.0028	
1/12/2018 8:00	116	41	75	cloudy	55	0.0042	
1/12/2018 9:00	130	43	87	cloudy	56	0.024	
1/12/2018 10:00	217	111	106	cloudy	56	0.0151	
1/12/2018 11:00	308	187	121	cloudy	58	0.0218	
1/12/2018 12:00	463	228	235	rain	58	0.0711	
1/12/2018 13:00	399	206	193	rain	60	0.0907	
1/12/2018 14:00	280	116	164	rain	59	0.0721	
1/12/2018 15:00	193	130	63	rain	57	0.3584	
1/12/2018 16:00	353	228	125	rain	57	0.1472	
1/12/2018 17:00	223	137	86	partly-cloudy-night	58	0.0143	
1/12/2018 18:00	133	91	42	cloudy	57	0.0044	
1/12/2018 19:00	77	51	26	fog	57	0.0036	
1/12/2018 20:00	69	51	18	partly-cloudy-night	56	0.024	
1/12/2018 21:00	77	52	25	cloudy	55	0.0181	
1/12/2018 22:00	80	57	23	rain	55	0.0385	
1/12/2018 23:00	45	32	13	rain	56	0.033	
1/13/2018 0:00	43	30	13	cloudy	56	0.0188	
1/13/2018 1:00	16	13	3	partly-cloudy-night	56	0.0085	
1/13/2018 2:00	12	5	7	partly-cloudy-night	56	0.0051	
1/13/2018 3:00	8	5	3	cloudy	55	0.0208	
1/13/2018 4:00	2	1	1	rain	52	0.0494	
1/13/2018 5:00	6	4	2	cloudy	51	0.0161	
1/13/2018 6:00	14	6	8	partly-cloudy-night	52	0.0205	
1/13/2018 7:00	42	14	28	partly-cloudy-night	43	0.0026	
1/13/2018 8:00	130	78	52	partly-cloudy-day	35	0.0012	
1/13/2018 9:00	249	149	100	partly-cloudy-day	30	0.0002	
1/13/2018 10:00	687	406	281	partly-cloudy-day	29	0	
1/13/2018 11:00	1045	579	466	partly-cloudy-day	29	0.0001	
1/13/2018 12:00	1254	604	650	partly-cloudy-day	31	0	
1/13/2018 13:00	1433	620	813	clear-day	33	0	
1/13/2018 14:00	1455	739	716	clear-day	34	0.0001	
1/13/2018 15:00	1582	701	881	clear-day	33	0.0001	
1/13/2018 16:00	1674	763	911	clear-day	30	0	
1/13/2018 17:00	870	348	522	clear-night	28	0.0001	
1/13/2018 18:00	398	255	143	clear-night	26	0.0001	
1/13/2018 19:00	238	145	93	clear-night	24	0.0001	
1/13/2018 20:00	97	36	61	clear-night	23	0	
1/13/2018 21:00	50	23	27	clear-night	22	0	
1/13/2018 22:00	69	40	29	clear-night	21	0	
1/13/2018 23:00	46	39	7	clear-night	19	0	
1/14/2018 0:00	12	6	6	clear-night	18	0	
1/14/2018 1:00	4	2	2	clear-night	17	0	
1/14/2018 2:00	5	3	2	clear-night	17	0	
1/14/2018 3:00	0	0	0	clear-night	16	0	
1/14/2018 4:00	1	0	1	clear-night	16	0	
1/14/2018 5:00	2	1	1	clear-night	15	0	
1/14/2018 6:00	20	14	6	clear-night	15	0	
1/14/2018 7:00	44	24	20	clear-night	15	0	
1/14/2018 8:00	85	48	37	clear-day	15	0	
1/14/2018 9:00	286	172	114	clear-day	15	0	
1/14/2018 10:00	571	333	238	clear-day	18	0	
1/14/2018 11:00	726	385	341	clear-day	19	0	
1/14/2018 12:00	1052	553	499	clear-day	21	0	
1/14/2018 13:00	1005	467	538	clear-day	23	0	
1/14/2018 14:00	1111	531	580	clear-day	24	0	
1/14/2018 15:00	1162	557	605	clear-day	24	0	
1/14/2018 16:00	1214	606	608	clear-day	24	0	
1/14/2018 17:00	681	253	428	clear-night	22	0	
1/14/2018 18:00	284	182	102	clear-night	21	0	
1/14/2018 19:00	205	116	89	clear-night	20	0	
1/14/2018 20:00	120	86	34	clear-night	19	0	
1/14/2018 21:00	52	26	26	clear-night	18	0	
1/14/2018 22:00	28	9	19	clear-night	18	0	
1/14/2018 23:00	17	12	5	clear-night	17	0	
1/15/2018 0:00	8	4	4	clear-night	17	0	Martin Luther King Jr. Day
1/15/2018 1:00	1	0	1	clear-night	17	0	Martin Luther King Jr. Day
1/15/2018 2:00	3	2	1	clear-night	17	0	Martin Luther King Jr. Day
1/15/2018 3:00	2	0	2	clear-night	16	0	Martin Luther King Jr. Day
1/15/2018 4:00	4	1	3	partly-cloudy-night	17	0	Martin Luther King Jr. Day
1/15/2018 5:00	3	0	3	partly-cloudy-night	16	0	Martin Luther King Jr. Day
1/15/2018 6:00	10	8	2	partly-cloudy-night	18	0	Martin Luther King Jr. Day
1/15/2018 7:00	56	22	34	partly-cloudy-night	18	0	Martin Luther King Jr. Day
1/15/2018 8:00	65	29	36	clear-day	19	0	Martin Luther King Jr. Day
1/15/2018 9:00	192	104	88	clear-day	21	0	Martin Luther King Jr. Day
1/15/2018 10:00	447	248	199	clear-day	24	0	Martin Luther King Jr. Day
1/15/2018 11:00	674	340	334	partly-cloudy-day	26	0	Martin Luther King Jr. Day
1/15/2018 12:00	756	368	388	partly-cloudy-day	27	0	Martin Luther King Jr. Day
1/15/2018 13:00	939	447	492	partly-cloudy-day	28	0	Martin Luther King Jr. Day
1/15/2018 14:00	831	403	428	partly-cloudy-day	30	0	Martin Luther King Jr. Day
1/15/2018 15:00	889	448	441	partly-cloudy-day	30	0.0001	Martin Luther King Jr. Day
1/15/2018 16:00	955	407	548	clear-day	30	0	Martin Luther King Jr. Day
1/15/2018 17:00	510	204	306	clear-night	28	0	Martin Luther King Jr. Day
1/15/2018 18:00	261	121	140	clear-night	27	0	Martin Luther King Jr. Day
1/15/2018 19:00	149	65	84	clear-night	26	0	Martin Luther King Jr. Day
1/15/2018 20:00	90	43	47	clear-night	26	0	Martin Luther King Jr. Day
1/15/2018 21:00	43	21	22	clear-night	25	0	Martin Luther King Jr. Day
1/15/2018 22:00	14	8	6	clear-night	25	0	Martin Luther King Jr. Day
1/15/2018 23:00	14	10	4	clear-night	24	0	Martin Luther King Jr. Day
1/16/2018 0:00	10	7	3	partly-cloudy-night	24	0	
1/16/2018 1:00	7	4	3	partly-cloudy-night	24	0	
1/16/2018 2:00	3	1	2	partly-cloudy-night	24	0	
1/16/2018 3:00	10	6	4	partly-cloudy-night	25	0	
1/16/2018 4:00	3	0	3	partly-cloudy-night	25	0	
1/16/2018 5:00	9	3	6	cloudy	25	0	
1/16/2018 6:00	36	14	22	cloudy	26	0	
1/16/2018 7:00	81	39	42	cloudy	26	0	
1/16/2018 8:00	152	45	107	partly-cloudy-day	27	0	
1/16/2018 9:00	206	97	109	partly-cloudy-day	28	0	
1/16/2018 10:00	275	139	136	partly-cloudy-day	30	0	
1/16/2018 11:00	491	247	244	partly-cloudy-day	32	0.0006	
1/16/2018 12:00	527	251	276	partly-cloudy-day	33	0.0026	
1/16/2018 13:00	631	292	339	partly-cloudy-day	35	0	
1/16/2018 14:00	662	344	318	partly-cloudy-day	35	0	
1/16/2018 15:00	603	266	337	partly-cloudy-day	36	0.0001	
1/16/2018 16:00	609	322	287	partly-cloudy-day	36	0	
1/16/2018 17:00	497	304	193	partly-cloudy-night	35	0	
1/16/2018 18:00	325	244	81	partly-cloudy-night	34	0	
1/16/2018 19:00	217	169	48	partly-cloudy-night	33	0	
1/16/2018 20:00	99	56	43	partly-cloudy-night	33	0	
1/16/2018 21:00	61	32	29	partly-cloudy-night	33	0	
1/16/2018 22:00	35	18	17	clear-night	34	0	
1/16/2018 23:00	18	11	7	partly-cloudy-night	34	0	
1/17/2018 0:00	16	7	9	partly-cloudy-night	35	0	
1/17/2018 1:00	9	5	4	partly-cloudy-night	35	0	
1/17/2018 2:00	4	3	1	partly-cloudy-night	35	0.0004	
1/17/2018 3:00	0	0	0	partly-cloudy-night	35	0.0032	
1/17/2018 4:00	3	1	2	cloudy	35	0.0049	
1/17/2018 5:00	6	4	2	cloudy	35	0.0049	
1/17/2018 6:00	12	7	5	cloudy	34	0.0115	
1/17/2018 7:00	53	20	33	cloudy	34	0.0113	
1/17/2018 8:00	87	18	69	partly-cloudy-day	33	0.0086	
1/17/2018 9:00	82	31	51	snow	33	0.0092	
1/17/2018 10:00	134	77	57	snow	33	0.0093	
1/17/2018 11:00	181	109	72	partly-cloudy-day	33	0.0065	
1/17/2018 12:00	229	137	92	partly-cloudy-day	33	0.0065	
1/17/2018 13:00	289	131	158	partly-cloudy-day	33	0.0029	
1/17/2018 14:00	326	176	150	snow	33	0.2005	
1/17/2018 15:00	376	201	175	partly-cloudy-day	33	0.0031	
1/17/2018 16:00	375	216	159	partly-cloudy-day	30	0.001	
1/17/2018 17:00	259	184	75	partly-cloudy-night	29	0	
1/17/2018 18:00	191	146	45	partly-cloudy-night	28	0	
1/17/2018 19:00	134	92	42	partly-cloudy-night	26	0.0001	
1/17/2018 20:00	59	38	21	clear-night	25	0.0027	
1/17/2018 21:00	38	21	17	partly-cloudy-night	23	0.0005	
1/17/2018 22:00	37	26	11	partly-cloudy-night	23	0	
1/17/2018 23:00	47	27	20	partly-cloudy-night	22	0	
1/18/2018 0:00	4	1	3	partly-cloudy-night	21	0	
1/18/2018 1:00	6	3	3	clear-night	20	0	
1/18/2018 2:00	2	1	1	clear-night	20	0	
1/18/2018 3:00	1	0	1	clear-night	18	0	
1/18/2018 4:00	3	2	1	clear-night	18	0	
1/18/2018 5:00	11	4	7	clear-night	18	0	
1/18/2018 6:00	32	14	18	clear-night	18	0	
1/18/2018 7:00	94	41	53	clear-night	19	0	
1/18/2018 8:00	142	44	98	clear-day	19	0	
1/18/2018 9:00	192	96	96	clear-day	21	0	
1/18/2018 10:00	363	201	162	clear-day	25	0	
1/18/2018 11:00	541	277	264	clear-day	27	0	
1/18/2018 12:00	681	299	382	clear-day	28	0	
1/18/2018 13:00	757	332	425	clear-day	29	0	
1/18/2018 14:00	714	341	373	clear-day	31	0.002	
1/18/2018 15:00	769	394	375	clear-day	31	0	
1/18/2018 16:00	799	353	446	clear-day	32	0	
1/18/2018 17:00	619	295	324	clear-night	30	0	
1/18/2018 18:00	340	221	119	clear-night	29	0	
1/18/2018 19:00	234	196	38	clear-night	28	0	
1/18/2018 20:00	180	156	24	clear-night	27	0	
1/18/2018 21:00	116	78	38	clear-night	27	0	
1/18/2018 22:00	45	27	18	clear-night	26	0	
1/18/2018 23:00	30	18	12	clear-night	25	0	
1/19/2018 0:00	10	6	4	clear-night	24	0	
1/19/2018 1:00	12	9	3	clear-night	23	0	
1/19/2018 2:00	2	1	1	clear-night	23	0	
1/19/2018 3:00	3	2	1	clear-night	22	0	
1/19/2018 4:00	0	0	0	clear-night	22	0	
1/19/2018 5:00	8	3	5	clear-night	22	0	
1/19/2018 6:00	46	24	22	clear-night	22	0	
1/19/2018 7:00	101	39	62	clear-night	23	0	
1/19/2018 8:00	151	46	105	clear-day	25	0	
1/19/2018 9:00	225	101	124	clear-day	27	0	
1/19/2018 10:00	374	211	163	clear-day	29	0	
1/19/2018 11:00	828	315	513	clear-day	32	0	
1/19/2018 12:00	755	343	412	clear-day	33	0	
1/19/2018 13:00	926	392	534	clear-day	34	0	
1/19/2018 14:00	1004	478	526	clear-day	36	0.0001	
1/19/2018 15:00	979	450	529	clear-day	36	0.0023	
1/19/2018 16:00	1050	599	451	clear-day	36	0.0041	
1/19/2018 17:00	824	414	410	clear-night	36	0.0012	
1/19/2018 18:00	385	261	124	clear-night	35	0.0003	
1/19/2018 19:00	176	105	71	clear-night	34	0	
1/19/2018 20:00	104	60	44	clear-night	34	0	
1/19/2018 21:00	94	55	39	clear-night	34	0	
1/19/2018 22:00	73	39	34	clear-night	33	0	
1/19/2018 23:00	102	66	36	clear-night	33	0	
1/20/2018 0:00	44	39	5	clear-night	34	0	
1/20/2018 1:00	20	16	4	clear-night	34	0	
1/20/2018 2:00	6	2	4	clear-night	34	0	
1/20/2018 3:00	6	3	3	clear-night	34	0	
1/20/2018 4:00	3	3	0	clear-night	34	0	
1/20/2018 5:00	5	5	0	clear-night	35	0	
1/20/2018 6:00	20	10	10	clear-night	35	0	
1/20/2018 7:00	116	64	52	clear-night	36	0	
1/20/2018 8:00	169	81	88	clear-day	37	0.0002	
1/20/2018 9:00	321	202	119	clear-day	40	0.0002	
1/20/2018 10:00	729	421	308	clear-day	45	0.0023	
1/20/2018 11:00	1344	687	657	clear-day	47	0.0084	
1/20/2018 12:00	1586	806	780	clear-day	49	0.007	
1/20/2018 13:00	1794	842	952	clear-day	50	0.0027	
1/20/2018 14:00	1916	923	993	clear-day	50	0.003	
1/20/2018 15:00	2307	1044	1263	clear-day	50	0.0027	
1/20/2018 16:00	2224	1023	1201	clear-day	48	0.0017	
1/20/2018 17:00	1287	516	771	clear-night	47	0.0014	
1/20/2018 18:00	608	307	301	clear-night	46	0.0007	
1/20/2018 19:00	357	179	178	clear-night	45	0.0004	
1/20/2018 20:00	202	87	115	clear-night	44	0.0001	
1/20/2018 21:00	143	75	68	clear-night	43	0.0001	
1/20/2018 22:00	124	55	69	clear-night	40	0	
1/20/2018 23:00	95	64	31	clear-night	40	0	
1/21/2018 0:00	101	85	16	clear-night	39	0	
1/21/2018 1:00	22	11	11	clear-night	38	0	
1/21/2018 2:00	10	6	4	clear-night	37	0	
1/21/2018 3:00	7	2	5	clear-night	37	0	
1/21/2018 4:00	2	0	2	clear-night	37	0	
1/21/2018 5:00	5	2	3	clear-night	36	0	
1/21/2018 6:00	27	20	7	clear-night	36	0	
1/21/2018 7:00	101	56	45	clear-night	35	0	
1/21/2018 8:00	197	103	94	clear-day	36	0	
1/21/2018 9:00	364	207	157	clear-day	40	0	
1/21/2018 10:00	656	391	265	clear-day	44	0	
1/21/2018 11:00	1018	539	479	clear-day	46	0.0004	
1/21/2018 12:00	1344	670	674	clear-day	46	0.0008	
1/21/2018 13:00	1466	659	807	clear-day	47	0.0012	
1/21/2018 14:00	1663	721	942	clear-day	49	0.001	
1/21/2018 15:00	1881	859	1022	clear-day	49	0.0004	
1/21/2018 16:00	1844	792	1052	partly-cloudy-day	49	0	
1/21/2018 17:00	1015	372	643	partly-cloudy-night	47	0	
1/21/2018 18:00	539	271	268	partly-cloudy-night	46	0	
1/21/2018 19:00	257	115	142	partly-cloudy-night	45	0	
1/21/2018 20:00	277	178	99	partly-cloudy-night	43	0	
1/21/2018 21:00	125	60	65	partly-cloudy-night	44	0	
1/21/2018 22:00	74	38	36	cloudy	44	0	
1/21/2018 23:00	33	21	12	cloudy	44	0	
1/22/2018 0:00	9	4	5	cloudy	44	0	
1/22/2018 1:00	8	3	5	cloudy	43	0.0001	
1/22/2018 2:00	5	1	4	partly-cloudy-night	42	0.0009	
1/22/2018 3:00	1	0	1	partly-cloudy-night	41	0.003	
1/22/2018 4:00	4	1	3	partly-cloudy-night	41	0.0006	
1/22/2018 5:00	17	8	9	partly-cloudy-night	40	0.0009	
1/22/2018 6:00	45	20	25	partly-cloudy-night	40	0.0001	
1/22/2018 7:00	139	67	72	partly-cloudy-night	40	0	
1/22/2018 8:00	233	73	160	partly-cloudy-day	40	0.0002	
1/22/2018 9:00	278	136	142	partly-cloudy-day	41	0	
1/22/2018 10:00	362	143	219	partly-cloudy-day	42	0	
1/22/2018 11:00	563	299	264	partly-cloudy-day	45	0	
1/22/2018 12:00	719	374	345	clear-day	46	0	
1/22/2018 13:00	718	324	394	clear-day	47	0	
1/22/2018 14:00	725	333	392	partly-cloudy-day	47	0	
1/22/2018 15:00	775	379	396	partly-cloudy-day	46	0	
1/22/2018 16:00	607	329	278	partly-cloudy-day	45	0	
1/22/2018 17:00	662	420	242	partly-cloudy-night	44	0.0001	
1/22/2018 18:00	489	351	138	partly-cloudy-night	42	0	
1/22/2018 19:00	263	189	74	partly-cloudy-night	41	0	
1/22/2018 20:00	82	57	25	partly-cloudy-night	40	0	
1/22/2018 21:00	80	55	25	partly-cloudy-night	40	0	
1/22/2018 22:00	34	25	9	cloudy	39	0	
1/22/2018 23:00	24	19	5	fog	39	0	
1/23/2018 0:00	7	5	2	fog	39	0	
1/23/2018 1:00	5	4	1	fog	38	0	
1/23/2018 2:00	5	3	2	cloudy	39	0	
1/23/2018 3:00	1	0	1	cloudy	39	0	
1/23/2018 4:00	5	2	3	fog	40	0	
1/23/2018 5:00	7	5	2	fog	41	0	
1/23/2018 6:00	15	9	6	rain	43	0.0257	
1/23/2018 7:00	38	18	20	rain	45	0.1314	
1/23/2018 8:00	103	30	73	rain	45	0.1535	
1/23/2018 9:00	97	29	68	rain	49	0.0286	
1/23/2018 10:00	113	70	43	rain	52	0.039	
1/23/2018 11:00	166	81	85	rain	53	0.028	
1/23/2018 12:00	221	125	96	partly-cloudy-day	55	0.0103	
1/23/2018 13:00	323	172	151	rain	55	0.0458	
1/23/2018 14:00	484	259	225	partly-cloudy-day	57	0.0116	
1/23/2018 15:00	642	272	370	partly-cloudy-day	57	0	
1/23/2018 16:00	530	235	295	partly-cloudy-day	56	0	
1/23/2018 17:00	345	209	136	partly-cloudy-night	53	0.0155	
1/23/2018 18:00	319	239	80	partly-cloudy-night	51	0.0048	
1/23/2018 19:00	283	207	76	partly-cloudy-night	50	0.0002	
1/23/2018 20:00	155	109	46	clear-night	48	0	
1/23/2018 21:00	75	47	28	clear-night	46	0	
1/23/2018 22:00	60	37	23	clear-night	44	0	
1/23/2018 23:00	39	24	15	clear-night	44	0	
1/24/2018 0:00	15	8	7	clear-night	43	0	
1/24/2018 1:00	14	6	8	clear-night	42	0	
1/24/2018 2:00	3	1	2	clear-night	41	0	
1/24/2018 3:00	1	0	1	clear-night	40	0	
1/24/2018 4:00	7	1	6	partly-cloudy-night	41	0	
1/24/2018 5:00	19	12	7	cloudy	42	0	
1/24/2018 6:00	81	45	36	cloudy	41	0	
1/24/2018 7:00	175	68	107	cloudy	41	0	
1/24/2018 8:00	225	69	156	partly-cloudy-day	41	0	
1/24/2018 9:00	260	108	152	partly-cloudy-day	40	0	
1/24/2018 10:00	436	256	180	partly-cloudy-day	39	0	
1/24/2018 11:00	535	298	237	partly-cloudy-day	40	0	
1/24/2018 12:00	818	357	461	partly-cloudy-day	40	0	
1/24/2018 13:00	796	359	437	partly-cloudy-day	40	0	
1/24/2018 14:00	848	425	423	partly-cloudy-day	39	0	
1/24/2018 15:00	817	394	423	partly-cloudy-day	38	0	
1/24/2018 16:00	845	422	423	partly-cloudy-day	36	0	
1/24/2018 17:00	626	322	304	partly-cloudy-night	34	0	
1/24/2018 18:00	404	271	133	clear-night	33	0	
1/24/2018 19:00	181	110	71	clear-night	32	0	
1/24/2018 20:00	194	157	37	clear-night	31	0	
1/24/2018 21:00	66	43	23	clear-night	30	0	
1/24/2018 22:00	36	26	10	clear-night	28	0	
1/24/2018 23:00	66	64	2	clear-night	28	0	
1/25/2018 0:00	14	6	8	clear-night	26	0	
1/25/2018 1:00	4	3	1	clear-night	25	0	
1/25/2018 2:00	1	0	1	clear-night	24	0	
1/25/2018 3:00	2	1	1	clear-night	23	0	
1/25/2018 4:00	2	0	2	clear-night	23	0	
1/25/2018 5:00	8	4	4	clear-night	23	0	
1/25/2018 6:00	40	18	22	clear-night	23	0	
1/25/2018 7:00	90	43	47	clear-night	23	0	
1/25/2018 8:00	162	49	113	clear-day	24	0	
1/25/2018 9:00	193	94	99	clear-day	26	0	
1/25/2018 10:00	370	200	170	clear-day	27	0	
1/25/2018 11:00	544	280	264	clear-day	29	0	
1/25/2018 12:00	608	288	320	clear-day	30	0	
1/25/2018 13:00	681	282	399	clear-day	32	0	
1/25/2018 14:00	710	355	355	clear-day	33	0	
1/25/2018 15:00	712	324	388	clear-day	34	0	
1/25/2018 16:00	677	348	329	clear-day	33	0	
1/25/2018 17:00	657	317	340	clear-day	32	0	
1/25/2018 18:00	338	216	122	clear-night	32	0	
1/25/2018 19:00	159	113	46	clear-night	31	0	
1/25/2018 20:00	83	50	33	clear-night	30	0	
1/25/2018 21:00	102	83	19	clear-night	29	0	
1/25/2018 22:00	40	30	10	partly-cloudy-night	28	0	
1/25/2018 23:00	93	89	4	clear-night	27	0	
1/26/2018 0:00	39	28	11	partly-cloudy-night	28	0	
1/26/2018 1:00	7	6	1	partly-cloudy-night	27	0	
1/26/2018 2:00	0	0	0	partly-cloudy-night	27	0	
1/26/2018 3:00	0	0	0	clear-night	26	0	
1/26/2018 4:00	2	1	1	clear-night	26	0	
1/26/2018 5:00	10	6	4	clear-night	25	0	
1/26/2018 6:00	55	33	22	clear-night	25	0	
1/26/2018 7:00	128	57	71	clear-night	25	0	
1/26/2018 8:00	159	52	107	clear-day	26	0	
1/26/2018 9:00	283	146	137	clear-day	28	0	
1/26/2018 10:00	499	282	217	clear-day	30	0	
1/26/2018 11:00	662	351	311	clear-day	32	0	
1/26/2018 12:00	855	379	476	clear-day	33	0	
1/26/2018 13:00	963	445	518	clear-day	34	0	
1/26/2018 14:00	966	455	511	clear-day	35	0	
1/26/2018 15:00	1005	458	547	clear-day	37	0	
1/26/2018 16:00	1015	470	545	clear-day	36	0	
1/26/2018 17:00	811	368	443	clear-day	35	0	
1/26/2018 18:00	329	209	120	clear-night	33	0	
1/26/2018 19:00	232	165	67	clear-night	33	0	
1/26/2018 20:00	93	56	37	clear-night	33	0	
1/26/2018 21:00	85	53	32	clear-night	32	0	
1/26/2018 22:00	38	25	13	clear-night	32	0	
1/26/2018 23:00	42	18	24	clear-night	31	0	
1/27/2018 0:00	22	14	8	clear-night	31	0	
1/27/2018 1:00	17	9	8	clear-night	32	0	
1/27/2018 2:00	8	4	4	clear-night	32	0	
1/27/2018 3:00	1	0	1	clear-night	32	0	
1/27/2018 4:00	2	1	1	clear-night	32	0	
1/27/2018 5:00	2	2	0	clear-night	32	0	
1/27/2018 6:00	21	17	4	clear-night	33	0	
1/27/2018 7:00	113	49	64	clear-night	33	0	
1/27/2018 8:00	184	98	86	clear-day	34	0	
1/27/2018 9:00	398	198	200	clear-day	35	0	
1/27/2018 10:00	810	461	349	clear-day	38	0	
1/27/2018 11:00	1310	659	651	clear-day	41	0	
1/27/2018 12:00	1821	885	936	clear-day	46	0	
1/27/2018 13:00	2127	998	1129	clear-day	50	0	
1/27/2018 14:00	2314	1111	1203	clear-day	51	0	
1/27/2018 15:00	2514	1156	1358	clear-day	51	0	
1/27/2018 16:00	2308	1030	1278	clear-day	53	0	
1/27/2018 17:00	1505	634	871	clear-day	53	0	
1/27/2018 18:00	702	315	387	clear-night	52	0	
1/27/2018 19:00	466	260	206	partly-cloudy-night	52	0	
1/27/2018 20:00	323	154	169	clear-night	52	0	
1/27/2018 21:00	250	111	139	clear-night	51	0	
1/27/2018 22:00	141	76	65	partly-cloudy-night	51	0	
1/27/2018 23:00	198	142	56	clear-night	51	0	
1/28/2018 0:00	151	135	16	clear-night	52	0	
1/28/2018 1:00	15	9	6	partly-cloudy-night	51	0	
1/28/2018 2:00	11	8	3	partly-cloudy-night	52	0	
1/28/2018 3:00	2	1	1	partly-cloudy-night	50	0.0094	
1/28/2018 4:00	0	0	0	partly-cloudy-night	49	0.0148	
1/28/2018 5:00	1	0	1	partly-cloudy-night	48	0.0178	
1/28/2018 6:00	4	3	1	rain	48	0.0315	
1/28/2018 7:00	38	17	21	rain	48	0.0276	
1/28/2018 8:00	56	21	35	partly-cloudy-day	47	0.0155	
1/28/2018 9:00	134	84	50	partly-cloudy-day	46	0.0122	
1/28/2018 10:00	277	158	119	partly-cloudy-day	47	0.0078	
1/28/2018 11:00	514	261	253	partly-cloudy-day	47	0.0039	
1/28/2018 12:00	526	277	249	partly-cloudy-day	47	0.011	
1/28/2018 13:00	657	319	338	partly-cloudy-day	47	0.0091	
1/28/2018 14:00	788	413	375	partly-cloudy-day	49	0.0021	
1/28/2018 15:00	1046	505	541	partly-cloudy-day	49	0	
1/28/2018 16:00	1042	514	528	partly-cloudy-day	49	0	
1/28/2018 17:00	697	324	373	partly-cloudy-day	47	0	
1/28/2018 18:00	483	275	208	partly-cloudy-night	47	0	
1/28/2018 19:00	316	203	113	partly-cloudy-night	47	0	
1/28/2018 20:00	236	150	86	partly-cloudy-night	46	0	
1/28/2018 21:00	138	63	75	partly-cloudy-night	45	0	
1/28/2018 22:00	91	52	39	partly-cloudy-night	45	0	
1/28/2018 23:00	36	20	16	clear-night	43	0	
1/29/2018 0:00	31	14	17	clear-night	43	0	
1/29/2018 1:00	9	5	4	partly-cloudy-night	42	0	
1/29/2018 2:00	14	10	4	clear-night	42	0	
1/29/2018 3:00	10	4	6	clear-night	41	0	
1/29/2018 4:00	2	0	2	clear-night	41	0	
1/29/2018 5:00	18	11	7	clear-night	40	0	
1/29/2018 6:00	70	32	38	clear-night	41	0	
1/29/2018 7:00	125	55	70	clear-night	40	0	
1/29/2018 8:00	234	79	155	clear-day	40	0	
1/29/2018 9:00	307	136	171	clear-day	40	0	
1/29/2018 10:00	487	281	206	clear-day	41	0	
1/29/2018 11:00	758	363	395	clear-day	42	0.0003	
1/29/2018 12:00	840	397	443	clear-day	42	0	
1/29/2018 13:00	871	404	467	partly-cloudy-day	42	0	
1/29/2018 14:00	873	415	458	partly-cloudy-day	42	0	
1/29/2018 15:00	823	412	411	partly-cloudy-day	42	0	
1/29/2018 16:00	757	341	416	partly-cloudy-day	42	0	
1/29/2018 17:00	611	334	277	partly-cloudy-day	42	0	
1/29/2018 18:00	490	352	138	partly-cloudy-night	41	0	
1/29/2018 19:00	275	181	94	cloudy	40	0	
1/29/2018 20:00	128	69	59	partly-cloudy-night	39	0	
1/29/2018 21:00	89	50	39	partly-cloudy-night	39	0	
1/29/2018 22:00	49	27	22	cloudy	38	0	
1/29/2018 23:00	28	11	17	partly-cloudy-night	37	0	
1/30/2018 0:00	13	8	5	partly-cloudy-night	34	0.0005	
1/30/2018 1:00	0	0	0	partly-cloudy-night	32	0.0014	
1/30/2018 2:00	1	0	1	partly-cloudy-night	31	0.0016	
1/30/2018 3:00	1	0	1	partly-cloudy-night	31	0.0015	
1/30/2018 4:00	0	0	0	partly-cloudy-night	30	0.0047	
1/30/2018 5:00	0	0	0	partly-cloudy-night	30	0.0067	
1/30/2018 6:00	11	8	3	partly-cloudy-night	30	0.0055	
1/30/2018 7:00	65	30	35	partly-cloudy-night	30	0.0029	
1/30/2018 8:00	128	28	100	partly-cloudy-day	30	0.0006	
1/30/2018 9:00	168	87	81	partly-cloudy-day	31	0.0017	
1/30/2018 10:00	264	151	113	partly-cloudy-day	32	0.0004	
1/30/2018 11:00	376	200	176	partly-cloudy-day	33	0.0017	
1/30/2018 12:00	524	222	302	partly-cloudy-day	34	0.0013	
1/30/2018 13:00	519	250	269	partly-cloudy-day	35	0.0015	
1/30/2018 14:00	510	252	258	rain	35	0.0933	
1/30/2018 15:00	481	251	230	partly-cloudy-day	35	0.0015	
1/30/2018 16:00	553	275	278	partly-cloudy-day	34	0.0005	
1/30/2018 17:00	432	251	181	partly-cloudy-day	32	0.0004	
1/30/2018 18:00	332	255	77	partly-cloudy-night	30	0.0023	
1/30/2018 19:00	135	102	33	partly-cloudy-night	29	0	
1/30/2018 20:00	132	105	27	partly-cloudy-night	27	0	
1/30/2018 21:00	55	33	22	partly-cloudy-night	27	0	
1/30/2018 22:00	29	14	15	clear-night	26	0	
1/30/2018 23:00	8	4	4	clear-night	25	0	
1/31/2018 0:00	9	8	1	clear-night	24	0	
1/31/2018 1:00	5	0	5	clear-night	22	0	
1/31/2018 2:00	3	2	1	clear-night	22	0	
1/31/2018 3:00	4	2	2	clear-night	21	0	
1/31/2018 4:00	5	4	1	clear-night	19	0	
1/31/2018 5:00	11	4	7	clear-night	19	0	
1/31/2018 6:00	57	32	25	clear-night	18	0	
1/31/2018 7:00	107	45	62	clear-night	18	0	
1/31/2018 8:00	143	43	100	clear-day	18	0	
1/31/2018 9:00	169	82	87	clear-day	20	0	
1/31/2018 10:00	315	180	135	clear-day	22	0.0001	
1/31/2018 11:00	514	244	270	clear-day	24	0	
1/31/2018 12:00	694	351	343	clear-day	26	0	
1/31/2018 13:00	735	354	381	clear-day	28	0.0006	
1/31/2018 14:00	752	351	401	clear-day	30	0	
1/31/2018 15:00	711	338	373	clear-day	31	0	
1/31/2018 16:00	747	352	395	partly-cloudy-day	31	0	
1/31/2018 17:00	571	294	277	partly-cloudy-day	31	0	
1/31/2018 18:00	420	312	108	clear-night	30	0	
1/31/2018 19:00	297	216	81	clear-night	30	0	
1/31/2018 20:00	213	169	44	clear-night	31	0.0007	
1/31/2018 21:00	96	74	22	clear-night	30	0	
1/31/2018 22:00	61	48	13	clear-night	30	0	
1/31/2018 23:00	57	49	8	clear-night	30	0	
2/1/2018 0:00	12	2	10	partly-cloudy-night	31	0	
2/1/2018 1:00	2	0	2	partly-cloudy-night	31	0	
2/1/2018 2:00	1	0	1	clear-night	31	0	
2/1/2018 3:00	5	3	2	clear-night	31	0	
2/1/2018 4:00	2	1	1	partly-cloudy-night	32	0	
2/1/2018 5:00	10	7	3	clear-night	32	0	
2/1/2018 6:00	56	28	28	partly-cloudy-night	33	0	
2/1/2018 7:00	106	42	64	partly-cloudy-night	33	0	
2/1/2018 8:00	220	61	159	partly-cloudy-day	34	0	
2/1/2018 9:00	198	83	115	partly-cloudy-day	34	0	
2/1/2018 10:00	343	184	159	partly-cloudy-day	36	0	
2/1/2018 11:00	535	310	225	clear-day	37	0	
2/1/2018 12:00	642	304	338	partly-cloudy-day	39	0	
2/1/2018 13:00	845	366	479	clear-day	40	0	
2/1/2018 14:00	754	317	437	clear-day	41	0	
2/1/2018 15:00	849	329	520	clear-day	42	0	
2/1/2018 16:00	641	285	356	partly-cloudy-day	42	0	
2/1/2018 17:00	593	339	254	partly-cloudy-day	42	0	
2/1/2018 18:00	401	268	133	partly-cloudy-night	42	0	
2/1/2018 19:00	237	174	63	cloudy	41	0.0023	
2/1/2018 20:00	252	195	57	partly-cloudy-night	40	0.0024	
2/1/2018 21:00	135	92	43	partly-cloudy-night	41	0.0019	
2/1/2018 22:00	72	46	26	cloudy	39	0.0001	
2/1/2018 23:00	16	9	7	partly-cloudy-night	40	0.0045	
2/2/2018 0:00	6	4	2	partly-cloudy-night	38	0.0149	
2/2/2018 1:00	1	0	1	partly-cloudy-night	38	0.0229	
2/2/2018 2:00	1	0	1	rain	37	0.048	
2/2/2018 3:00	0	0	0	rain	37	0.0382	
2/2/2018 4:00	1	0	1	cloudy	36	0.0189	
2/2/2018 5:00	3	0	3	partly-cloudy-night	35	0.0114	
2/2/2018 6:00	27	19	8	partly-cloudy-night	32	0.0005	
2/2/2018 7:00	96	39	57	partly-cloudy-night	29	0	
2/2/2018 8:00	123	43	80	partly-cloudy-day	28	0.0006	
2/2/2018 9:00	205	98	107	clear-day	27	0	
2/2/2018 10:00	321	183	138	clear-day	27	0.0012	
2/2/2018 11:00	493	272	221	clear-day	26	0	
2/2/2018 12:00	635	307	328	partly-cloudy-day	26	0	
2/2/2018 13:00	649	282	367	partly-cloudy-day	26	0	
2/2/2018 14:00	616	279	337	partly-cloudy-day	26	0	
2/2/2018 15:00	729	369	360	partly-cloudy-day	25	0	
2/2/2018 16:00	593	309	284	partly-cloudy-day	25	0	
2/2/2018 17:00	510	266	244	partly-cloudy-day	23	0.0006	
2/2/2018 18:00	312	246	66	partly-cloudy-night	22	0	
2/2/2018 19:00	113	77	36	partly-cloudy-night	20	0	
2/2/2018 20:00	47	35	12	clear-night	19	0	
2/2/2018 21:00	31	15	16	clear-night	18	0	
2/2/2018 22:00	23	16	7	clear-night	17	0	
2/2/2018 23:00	32	21	11	clear-night	17	0	
2/3/2018 0:00	4	2	2	clear-night	17	0	
2/3/2018 1:00	1	0	1	clear-night	16	0	
2/3/2018 2:00	3	0	3	clear-night	16	0	
2/3/2018 3:00	5	2	3	clear-night	16	0	
2/3/2018 4:00	0	0	0	clear-night	16	0	
2/3/2018 5:00	3	1	2	clear-night	15	0.0004	
2/3/2018 6:00	15	12	3	clear-night	16	0	
2/3/2018 7:00	57	33	24	clear-night	17	0	
2/3/2018 8:00	125	62	63	clear-day	18	0	
2/3/2018 9:00	270	179	91	clear-day	20	0	
2/3/2018 10:00	607	328	279	clear-day	23	0	
2/3/2018 11:00	828	439	389	clear-day	26	0	
2/3/2018 12:00	1191	579	612	partly-cloudy-day	26	0	
2/3/2018 13:00	1351	671	680	partly-cloudy-day	27	0	
2/3/2018 14:00	1331	671	660	clear-day	29	0	
2/3/2018 15:00	1337	691	646	clear-day	30	0	
2/3/2018 16:00	1546	700	846	clear-day	30	0	
2/3/2018 17:00	1176	504	672	clear-day	30	0	
2/3/2018 18:00	514	309	205	clear-night	29	0	
2/3/2018 19:00	368	233	135	clear-night	29	0	
2/3/2018 20:00	202	149	53	clear-night	28	0	
2/3/2018 21:00	74	50	24	clear-night	28	0	
2/3/2018 22:00	42	27	15	partly-cloudy-night	28	0	
2/3/2018 23:00	84	67	17	cloudy	28	0	
2/4/2018 0:00	70	55	15	cloudy	29	0	
2/4/2018 1:00	12	5	7	partly-cloudy-night	29	0	
2/4/2018 2:00	6	3	3	cloudy	29	0	
2/4/2018 3:00	4	3	1	cloudy	30	0	
2/4/2018 4:00	1	0	1	cloudy	30	0	
2/4/2018 5:00	1	0	1	partly-cloudy-night	30	0	
2/4/2018 6:00	7	3	4	partly-cloudy-night	31	0	
2/4/2018 7:00	56	27	29	partly-cloudy-night	32	0	
2/4/2018 8:00	137	71	66	partly-cloudy-day	33	0	
2/4/2018 9:00	315	197	118	partly-cloudy-day	34	0	
2/4/2018 10:00	602	347	255	partly-cloudy-day	35	0	
2/4/2018 11:00	777	423	354	partly-cloudy-day	38	0	
2/4/2018 12:00	934	421	513	partly-cloudy-day	39	0	
2/4/2018 13:00	722	367	355	partly-cloudy-day	38	0.0001	
2/4/2018 14:00	795	410	385	partly-cloudy-day	38	0.007	
2/4/2018 15:00	725	281	444	partly-cloudy-day	39	0.0001	
2/4/2018 16:00	475	217	258	partly-cloudy-day	39	0.0022	
2/4/2018 17:00	194	91	103	partly-cloudy-day	39	0.0072	
2/4/2018 18:00	96	83	13	rain	41	0.0455	
2/4/2018 19:00	32	27	5	rain	41	0.0902	
2/4/2018 20:00	11	10	1	rain	42	0.1516	
2/4/2018 21:00	8	7	1	rain	42	0.289	
2/4/2018 22:00	6	4	2	rain	40	0.1318	
2/4/2018 23:00	6	5	1	rain	40	0.0671	
2/5/2018 0:00	0	0	0	partly-cloudy-night	39	0.0099	
2/5/2018 1:00	0	0	0	partly-cloudy-night	38	0.0031	
2/5/2018 2:00	5	2	3	clear-night	37	0.0009	
2/5/2018 3:00	1	0	1	clear-night	37	0	
2/5/2018 4:00	0	0	0	clear-night	36	0	
2/5/2018 5:00	2	0	2	clear-night	36	0	
2/5/2018 6:00	50	34	16	clear-night	36	0.0005	
2/5/2018 7:00	109	44	65	partly-cloudy-night	36	0	
2/5/2018 8:00	198	61	137	partly-cloudy-day	36	0	
2/5/2018 9:00	322	161	161	partly-cloudy-day	34	0	
2/5/2018 10:00	671	313	358	clear-day	31	0.0006	
2/5/2018 11:00	883	435	448	clear-day	31	0.0009	
2/5/2018 12:00	912	400	512	clear-day	30	0.0021	
2/5/2018 13:00	827	350	477	clear-day	30	0	
2/5/2018 14:00	890	428	462	clear-day	31	0	
2/5/2018 15:00	919	455	464	clear-day	31	0	
2/5/2018 16:00	1010	533	477	clear-day	31	0	
2/5/2018 17:00	840	401	439	clear-day	30	0	
2/5/2018 18:00	448	281	167	clear-night	29	0	
2/5/2018 19:00	229	153	76	clear-night	28	0	
2/5/2018 20:00	74	34	40	clear-night	27	0	
2/5/2018 21:00	52	28	24	clear-night	27	0	
2/5/2018 22:00	44	22	22	clear-night	26	0	
2/5/2018 23:00	26	9	17	clear-night	25	0	
2/6/2018 0:00	4	2	2	clear-night	25	0	
2/6/2018 1:00	6	0	6	clear-night	25	0	
2/6/2018 2:00	3	0	3	clear-night	25	0	
2/6/2018 3:00	3	2	1	clear-night	25	0	
2/6/2018 4:00	2	0	2	clear-night	26	0	
2/6/2018 5:00	20	11	9	clear-night	27	0	
2/6/2018 6:00	67	37	30	clear-night	27	0	
2/6/2018 7:00	128	58	70	partly-cloudy-night	28	0	
2/6/2018 8:00	197	53	144	partly-cloudy-day	28	0	
2/6/2018 9:00	251	130	121	partly-cloudy-day	29	0	
2/6/2018 10:00	426	254	172	partly-cloudy-day	29	0	
2/6/2018 11:00	717	326	391	partly-cloudy-day	31	0	
2/6/2018 12:00	718	354	364	partly-cloudy-day	33	0	
2/6/2018 13:00	780	374	406	partly-cloudy-day	34	0	
2/6/2018 14:00	842	371	471	partly-cloudy-day	35	0	
2/6/2018 15:00	903	426	477	partly-cloudy-day	36	0.0012	
2/6/2018 16:00	921	504	417	cloudy	36	0	
2/6/2018 17:00	808	407	401	partly-cloudy-day	35	0	
2/6/2018 18:00	443	310	133	clear-night	34	0.0008	
2/6/2018 19:00	284	206	78	clear-night	33	0	
2/6/2018 20:00	205	171	34	clear-night	32	0	
2/6/2018 21:00	77	49	28	clear-night	32	0.0002	
2/6/2018 22:00	62	30	32	clear-night	31	0.0026	
2/6/2018 23:00	35	18	17	clear-night	31	0	
2/7/2018 0:00	10	5	5	clear-night	30	0	
2/7/2018 1:00	3	0	3	clear-night	30	0	
2/7/2018 2:00	2	1	1	clear-night	30	0	
2/7/2018 3:00	2	0	2	clear-night	30	0	
2/7/2018 4:00	1	0	1	clear-night	30	0	
2/7/2018 5:00	7	2	5	clear-night	29	0	
2/7/2018 6:00	51	26	25	clear-night	29	0	
2/7/2018 7:00	87	35	52	partly-cloudy-night	30	0	
2/7/2018 8:00	128	28	100	partly-cloudy-day	30	0.0007	
2/7/2018 9:00	127	45	82	partly-cloudy-day	30	0.0028	
2/7/2018 10:00	120	50	70	snow	30	0.0139	
2/7/2018 11:00	169	83	86	snow	31	0.0187	
2/7/2018 12:00	186	79	107	cloudy	32	0.0179	
2/7/2018 13:00	93	28	65	rain	33	0.0266	
2/7/2018 14:00	80	46	34	rain	34	0.2192	
2/7/2018 15:00	73	40	33	rain	35	0.0539	
2/7/2018 16:00	69	41	28	rain	37	0.0605	
2/7/2018 17:00	111	89	22	rain	42	0.0561	
2/7/2018 18:00	95	92	3	rain	41	0.0922	
2/7/2018 19:00	48	46	2	rain	42	0.0457	
2/7/2018 20:00	38	34	4	partly-cloudy-night	39	0.0197	
2/7/2018 21:00	11	8	3	partly-cloudy-night	38	0.0218	
2/7/2018 22:00	16	13	3	partly-cloudy-night	38	0.0081	
2/7/2018 23:00	31	25	6	partly-cloudy-night	36	0.0037	
2/8/2018 0:00	11	7	4	partly-cloudy-night	32	0.0007	
2/8/2018 1:00	7	2	5	partly-cloudy-night	32	0	
2/8/2018 2:00	2	1	1	partly-cloudy-night	30	0	
2/8/2018 3:00	1	0	1	partly-cloudy-night	29	0.001	
2/8/2018 4:00	4	1	3	clear-night	28	0	
2/8/2018 5:00	16	6	10	clear-night	27	0	
2/8/2018 6:00	55	33	22	clear-night	26	0	
2/8/2018 7:00	123	51	72	partly-cloudy-night	25	0	
2/8/2018 8:00	181	65	116	clear-day	25	0	
2/8/2018 9:00	294	145	149	clear-day	27	0	
2/8/2018 10:00	634	353	281	clear-day	28	0.0009	
2/8/2018 11:00	987	423	564	clear-day	29	0.0007	
2/8/2018 12:00	1036	509	527	clear-day	31	0.0016	
2/8/2018 13:00	1104	470	634	partly-cloudy-day	31	0.0064	
2/8/2018 14:00	962	486	476	clear-day	31	0.0052	
2/8/2018 15:00	981	485	496	partly-cloudy-day	31	0.0058	
2/8/2018 16:00	1104	553	551	partly-cloudy-day	32	0.0019	
2/8/2018 17:00	994	474	520	partly-cloudy-day	31	0	
2/8/2018 18:00	542	338	204	partly-cloudy-night	30	0	
2/8/2018 19:00	283	216	67	partly-cloudy-night	29	0	
2/8/2018 20:00	165	137	28	partly-cloudy-night	28	0	
2/8/2018 21:00	159	136	23	clear-night	28	0	
2/8/2018 22:00	145	121	24	clear-night	27	0	
2/8/2018 23:00	19	14	5	clear-night	27	0	
2/9/2018 0:00	17	9	8	clear-night	26	0	
2/9/2018 1:00	3	0	3	clear-night	26	0	
2/9/2018 2:00	2	1	1	clear-night	26	0	
2/9/2018 3:00	6	2	4	clear-night	26	0	
2/9/2018 4:00	4	1	3	partly-cloudy-night	25	0	
2/9/2018 5:00	17	10	7	clear-night	25	0	
2/9/2018 6:00	56	36	20	clear-night	24	0	
2/9/2018 7:00	103	36	67	clear-night	25	0	
2/9/2018 8:00	186	66	120	clear-day	26	0	
2/9/2018 9:00	297	153	144	clear-day	27	0	
2/9/2018 10:00	590	365	225	partly-cloudy-day	28	0	
2/9/2018 11:00	906	427	479	partly-cloudy-day	31	0	
2/9/2018 12:00	1010	489	521	clear-day	32	0	
2/9/2018 13:00	1013	524	489	partly-cloudy-day	32	0.001	
2/9/2018 14:00	1036	483	553	partly-cloudy-day	32	0.0009	
2/9/2018 15:00	1041	483	558	partly-cloudy-day	32	0.0002	
2/9/2018 16:00	1032	455	577	partly-cloudy-day	33	0	
2/9/2018 17:00	709	374	335	partly-cloudy-day	34	0	
2/9/2018 18:00	463	279	184	partly-cloudy-night	34	0	
2/9/2018 19:00	254	181	73	clear-night	34	0	
2/9/2018 20:00	135	71	64	clear-night	34	0	
2/9/2018 21:00	98	53	45	clear-night	35	0	
2/9/2018 22:00	134	97	37	clear-night	36	0	
2/9/2018 23:00	201	173	28	clear-night	35	0	
2/10/2018 0:00	151	146	5	clear-night	36	0	
2/10/2018 1:00	25	16	9	clear-night	36	0	
2/10/2018 2:00	9	7	2	partly-cloudy-night	36	0	
2/10/2018 3:00	10	8	2	partly-cloudy-night	36	0	
2/10/2018 4:00	1	1	0	partly-cloudy-night	36	0	
2/10/2018 5:00	3	1	2	partly-cloudy-night	36	0	
2/10/2018 6:00	22	14	8	partly-cloudy-night	37	0	
2/10/2018 7:00	105	47	58	partly-cloudy-night	36	0	
2/10/2018 8:00	226	111	115	partly-cloudy-day	36	0.0011	
2/10/2018 9:00	549	299	250	partly-cloudy-day	40	0.0007	
2/10/2018 10:00	919	479	440	partly-cloudy-day	43	0.0027	
2/10/2018 11:00	1605	818	787	partly-cloudy-day	44	0.0055	
2/10/2018 12:00	1317	659	658	partly-cloudy-day	46	0.006	
2/10/2018 13:00	1054	447	607	partly-cloudy-day	45	0.0062	
2/10/2018 14:00	927	483	444	partly-cloudy-day	45	0.0104	
2/10/2018 15:00	581	309	272	rain	44	0.0467	
2/10/2018 16:00	750	417	333	rain	44	0.0517	
2/10/2018 17:00	576	268	308	partly-cloudy-day	44	0.0149	
2/10/2018 18:00	205	151	54	partly-cloudy-night	44	0.0061	
2/10/2018 19:00	119	96	23	rain	43	0.0354	
2/10/2018 20:00	93	84	9	rain	45	0.0875	
2/10/2018 21:00	60	56	4	rain	45	0.0443	
2/10/2018 22:00	109	105	4	rain	44	0.0368	
2/10/2018 23:00	96	91	5	partly-cloudy-night	44	0.0102	
2/11/2018 0:00	61	59	2	partly-cloudy-night	45	0.0051	
2/11/2018 1:00	6	4	2	cloudy	45	0.0227	
2/11/2018 2:00	7	6	1	rain	44	0.0301	
2/11/2018 3:00	2	0	2	rain	45	0.212	
2/11/2018 4:00	1	0	1	rain	45	0.03	
2/11/2018 5:00	2	0	2	rain	43	0.0283	
2/11/2018 6:00	5	4	1	rain	43	0.0266	
2/11/2018 7:00	22	11	11	rain	44	0.0291	
2/11/2018 8:00	68	33	35	rain	43	0.0415	
2/11/2018 9:00	120	77	43	rain	44	0.0507	
2/11/2018 10:00	239	144	95	rain	45	0.085	
2/11/2018 11:00	354	219	135	rain	46	0.2206	
2/11/2018 12:00	370	178	192	rain	47	0.23	
2/11/2018 13:00	232	114	118	rain	47	0.0439	
2/11/2018 14:00	310	172	138	rain	48	0.1221	
2/11/2018 15:00	392	216	176	rain	51	0.0314	
2/11/2018 16:00	483	292	191	partly-cloudy-day	54	0.0126	
2/11/2018 17:00	301	172	129	partly-cloudy-day	55	0.0137	
2/11/2018 18:00	151	114	37	rain	53	0.0313	
2/11/2018 19:00	111	82	29	partly-cloudy-night	55	0.0012	
2/11/2018 20:00	109	85	24	partly-cloudy-night	55	0.0033	
2/11/2018 21:00	97	47	50	partly-cloudy-night	54	0.0022	
2/11/2018 22:00	50	32	18	cloudy	54	0.0106	
2/11/2018 23:00	56	16	40	partly-cloudy-night	55	0.0013	
2/12/2018 0:00	16	6	10	partly-cloudy-night	56	0	
2/12/2018 1:00	11	6	5	partly-cloudy-night	59	0	
2/12/2018 2:00	10	8	2	partly-cloudy-night	59	0.0001	
2/12/2018 3:00	8	1	7	clear-night	57	0.0031	
2/12/2018 4:00	4	3	1	partly-cloudy-night	56	0	
2/12/2018 5:00	20	10	10	partly-cloudy-night	53	0.0001	
2/12/2018 6:00	79	41	38	partly-cloudy-night	46	0	
2/12/2018 7:00	149	63	86	partly-cloudy-day	43	0.0001	
2/12/2018 8:00	299	116	183	partly-cloudy-day	41	0	
2/12/2018 9:00	537	281	256	partly-cloudy-day	41	0	
2/12/2018 10:00	936	472	464	partly-cloudy-day	40	0.0006	
2/12/2018 11:00	1367	721	646	partly-cloudy-day	41	0	
2/12/2018 12:00	1326	625	701	partly-cloudy-day	40	0	
2/12/2018 13:00	1465	645	820	partly-cloudy-day	41	0	
2/12/2018 14:00	1476	742	734	clear-day	42	0	
2/12/2018 15:00	1622	875	747	clear-day	44	0	
2/12/2018 16:00	1729	857	872	clear-day	44	0	
2/12/2018 17:00	1487	800	687	clear-day	43	0	
2/12/2018 18:00	751	375	376	clear-night	41	0	
2/12/2018 19:00	391	284	107	clear-night	40	0	
2/12/2018 20:00	239	167	72	clear-night	38	0.0001	
2/12/2018 21:00	80	40	40	clear-night	37	0	
2/12/2018 22:00	46	26	20	clear-night	35	0	
2/12/2018 23:00	33	9	24	clear-night	33	0	
2/13/2018 0:00	14	9	5	clear-night	32	0	
2/13/2018 1:00	2	0	2	clear-night	31	0	
2/13/2018 2:00	0	0	0	clear-night	30	0	
2/13/2018 3:00	3	1	2	clear-night	29	0	
2/13/2018 4:00	2	0	2	clear-night	28	0	
2/13/2018 5:00	15	9	6	clear-night	27	0	
2/13/2018 6:00	55	27	28	clear-night	27	0	
2/13/2018 7:00	136	52	84	clear-day	25	0	
2/13/2018 8:00	227	86	141	clear-day	27	0	
2/13/2018 9:00	339	191	148	clear-day	28	0	
2/13/2018 10:00	716	374	342	clear-day	30	0	
2/13/2018 11:00	993	482	511	clear-day	31	0	
2/13/2018 12:00	1112	481	631	clear-day	33	0	
2/13/2018 13:00	1217	562	655	clear-day	35	0	
2/13/2018 14:00	1184	530	654	clear-day	35	0	
2/13/2018 15:00	1344	607	737	clear-day	36	0	
2/13/2018 16:00	1221	579	642	clear-day	35	0	
2/13/2018 17:00	994	455	539	clear-day	33	0	
2/13/2018 18:00	452	277	175	clear-night	32	0.0005	
2/13/2018 19:00	349	256	93	clear-night	32	0.0021	
2/13/2018 20:00	263	195	68	partly-cloudy-night	32	0	
2/13/2018 21:00	214	167	47	partly-cloudy-night	33	0	
2/13/2018 22:00	125	78	47	partly-cloudy-night	33	0	
2/13/2018 23:00	27	8	19	partly-cloudy-night	33	0	
2/14/2018 0:00	16	11	5	partly-cloudy-night	33	0	Valentine's Day
2/14/2018 1:00	7	4	3	partly-cloudy-night	33	0	Valentine's Day
2/14/2018 2:00	2	0	2	partly-cloudy-night	33	0	Valentine's Day
2/14/2018 3:00	2	0	2	partly-cloudy-night	34	0	Valentine's Day
2/14/2018 4:00	1	0	1	partly-cloudy-night	34	0.0004	Valentine's Day
2/14/2018 5:00	8	4	4	partly-cloudy-night	34	0.0032	Valentine's Day
2/14/2018 6:00	48	28	20	partly-cloudy-night	34	0.0006	Valentine's Day
2/14/2018 7:00	139	59	80	partly-cloudy-day	35	0	Valentine's Day
2/14/2018 8:00	218	66	152	partly-cloudy-day	36	0.0001	Valentine's Day
2/14/2018 9:00	341	170	171	partly-cloudy-day	36	0.0007	Valentine's Day
2/14/2018 10:00	688	366	322	partly-cloudy-day	38	0.0005	Valentine's Day
2/14/2018 11:00	1149	541	608	partly-cloudy-day	41	0.0001	Valentine's Day
2/14/2018 12:00	1063	487	576	partly-cloudy-day	44	0	Valentine's Day
2/14/2018 13:00	1059	439	620	clear-day	47	0.0013	Valentine's Day
2/14/2018 14:00	1032	490	542	partly-cloudy-day	48	0	Valentine's Day
2/14/2018 15:00	1112	532	580	partly-cloudy-day	50	0	Valentine's Day
2/14/2018 16:00	1173	626	547	partly-cloudy-day	51	0	Valentine's Day
2/14/2018 17:00	1079	609	470	partly-cloudy-day	50	0	Valentine's Day
2/14/2018 18:00	659	370	289	partly-cloudy-night	49	0	Valentine's Day
2/14/2018 19:00	409	251	158	clear-night	47	0	Valentine's Day
2/14/2018 20:00	325	232	93	clear-night	47	0	Valentine's Day
2/14/2018 21:00	249	190	59	partly-cloudy-night	47	0	Valentine's Day
2/14/2018 22:00	167	126	41	partly-cloudy-night	47	0	Valentine's Day
2/14/2018 23:00	109	102	7	partly-cloudy-night	46	0.0046	Valentine's Day
2/15/2018 0:00	81	79	2	partly-cloudy-night	45	0.0184	
2/15/2018 1:00	1	0	1	partly-cloudy-night	45	0.0087	
2/15/2018 2:00	4	2	2	partly-cloudy-night	44	0.0022	
2/15/2018 3:00	4	3	1	partly-cloudy-night	44	0.0104	
2/15/2018 4:00	5	2	3	partly-cloudy-night	44	0.0054	
2/15/2018 5:00	17	11	6	partly-cloudy-night	43	0.0001	
2/15/2018 6:00	48	26	22	partly-cloudy-night	44	0	
2/15/2018 7:00	149	64	85	partly-cloudy-day	43	0.0001	
2/15/2018 8:00	253	83	170	partly-cloudy-day	44	0	
2/15/2018 9:00	334	140	194	partly-cloudy-day	45	0	
2/15/2018 10:00	628	363	265	partly-cloudy-day	46	0	
2/15/2018 11:00	964	520	444	partly-cloudy-day	48	0.0021	
2/15/2018 12:00	1100	501	599	partly-cloudy-day	50	0	
2/15/2018 13:00	1110	546	564	partly-cloudy-day	51	0	
2/15/2018 14:00	1199	544	655	partly-cloudy-day	53	0	
2/15/2018 15:00	1256	555	701	clear-day	55	0	
2/15/2018 16:00	1144	623	521	clear-day	55	0	
2/15/2018 17:00	1131	562	569	clear-day	58	0	
2/15/2018 18:00	722	411	311	clear-night	55	0	
2/15/2018 19:00	481	325	156	clear-night	54	0	
2/15/2018 20:00	335	241	94	clear-night	55	0	
2/15/2018 21:00	210	158	52	partly-cloudy-night	55	0	
2/15/2018 22:00	97	94	3	partly-cloudy-night	53	0.0094	
2/15/2018 23:00	82	73	9	partly-cloudy-night	54	0.0137	
2/16/2018 0:00	64	57	7	partly-cloudy-night	54	0.0198	
2/16/2018 1:00	13	8	5	partly-cloudy-night	53	0.0136	
2/16/2018 2:00	11	6	5	partly-cloudy-night	53	0.0044	
2/16/2018 3:00	4	3	1	partly-cloudy-night	53	0.0074	
2/16/2018 4:00	3	0	3	partly-cloudy-night	54	0.0074	
2/16/2018 5:00	14	6	8	partly-cloudy-night	55	0.0117	
2/16/2018 6:00	34	18	16	partly-cloudy-night	55	0.01	
2/16/2018 7:00	69	33	36	partly-cloudy-day	54	0.0077	
2/16/2018 8:00	143	55	88	partly-cloudy-day	53	0.0055	
2/16/2018 9:00	252	115	137	partly-cloudy-day	53	0.0048	
2/16/2018 10:00	464	260	204	clear-day	53	0.0029	
2/16/2018 11:00	810	419	391	clear-day	54	0.0006	
2/16/2018 12:00	1097	556	541	clear-day	55	0	
2/16/2018 13:00	1133	534	599	partly-cloudy-day	56	0.0009	
2/16/2018 14:00	1161	516	645	clear-day	57	0.002	
2/16/2018 15:00	733	327	406	partly-cloudy-day	53	0.0036	
2/16/2018 16:00	526	238	288	partly-cloudy-day	50	0.0113	
2/16/2018 17:00	457	255	202	partly-cloudy-day	46	0.0057	
2/16/2018 18:00	300	158	142	clear-night	45	0.0028	
2/16/2018 19:00	296	207	89	clear-night	43	0.001	
2/16/2018 20:00	170	118	52	clear-night	42	0.0023	
2/16/2018 21:00	228	175	53	clear-night	40	0	
2/16/2018 22:00	71	35	36	clear-night	38	0	
2/16/2018 23:00	130	105	25	clear-night	36	0	
2/17/2018 0:00	22	14	8	clear-night	35	0	
2/17/2018 1:00	15	13	2	clear-night	34	0	
2/17/2018 2:00	10	5	5	clear-night	32	0	
2/17/2018 3:00	8	4	4	clear-night	31	0	
2/17/2018 4:00	3	1	2	clear-night	30	0	
2/17/2018 5:00	7	4	3	clear-night	29	0	
2/17/2018 6:00	41	28	13	clear-night	28	0	
2/17/2018 7:00	111	47	64	clear-day	28	0	
2/17/2018 8:00	204	96	108	clear-day	30	0	
2/17/2018 9:00	536	338	198	clear-day	32	0	
2/17/2018 10:00	1037	582	455	clear-day	34	0.0016	
2/17/2018 11:00	1523	788	735	clear-day	36	0	
2/17/2018 12:00	1988	990	998	clear-day	37	0	
2/17/2018 13:00	2145	924	1221	clear-day	37	0	
2/17/2018 14:00	2000	899	1101	partly-cloudy-day	36	0	
2/17/2018 15:00	1876	821	1055	cloudy	36	0	
2/17/2018 16:00	1630	770	860	partly-cloudy-day	36	0	
2/17/2018 17:00	964	408	556	partly-cloudy-day	36	0.0001	
2/17/2018 18:00	300	190	110	partly-cloudy-night	35	0.0045	
2/17/2018 19:00	138	95	43	snow	33	0.0129	
2/17/2018 20:00	37	16	21	snow	33	0.0393	
2/17/2018 21:00	16	7	9	snow	32	0.0398	
2/17/2018 22:00	11	5	6	snow	33	0.0329	
2/17/2018 23:00	12	6	6	snow	33	0.0283	
2/18/2018 0:00	4	3	1	snow	33	0.0166	
2/18/2018 1:00	5	3	2	cloudy	33	0.006	
2/18/2018 2:00	3	2	1	partly-cloudy-night	33	0.0026	
2/18/2018 3:00	1	0	1	partly-cloudy-night	33	0.0037	
2/18/2018 4:00	3	0	3	partly-cloudy-night	34	0.0005	
2/18/2018 5:00	1	0	1	partly-cloudy-night	34	0.0003	
2/18/2018 6:00	23	20	3	clear-night	34	0.0003	
2/18/2018 7:00	87	46	41	clear-day	34	0	
2/18/2018 8:00	168	92	76	clear-day	35	0.0019	
2/18/2018 9:00	536	359	177	clear-day	37	0.0001	
2/18/2018 10:00	1037	674	363	clear-day	38	0.0009	
2/18/2018 11:00	1618	872	746	clear-day	40	0.0065	
2/18/2018 12:00	1926	1080	846	clear-day	42	0.0161	
2/18/2018 13:00	2215	1132	1083	rain	43	0.0399	
2/18/2018 14:00	2420	1312	1108	rain	44	0.0579	
2/18/2018 15:00	2526	1417	1109	rain	45	0.0435	
2/18/2018 16:00	2586	1259	1327	clear-day	44	0.0108	
2/18/2018 17:00	2021	854	1167	clear-day	43	0.0039	
2/18/2018 18:00	969	373	596	clear-night	41	0.001	
2/18/2018 19:00	580	323	257	clear-night	39	0.0007	
2/18/2018 20:00	420	266	154	clear-night	39	0	
2/18/2018 21:00	148	61	87	clear-night	38	0	
2/18/2018 22:00	76	44	32	clear-night	36	0	
2/18/2018 23:00	85	36	49	clear-night	36	0	
2/19/2018 0:00	29	16	13	clear-night	35	0	Presidents' Day (regional holiday)
2/19/2018 1:00	15	10	5	clear-night	35	0	Presidents' Day (regional holiday)
2/19/2018 2:00	12	3	9	clear-night	35	0	Presidents' Day (regional holiday)
2/19/2018 3:00	4	3	1	clear-night	34	0	Presidents' Day (regional holiday)
2/19/2018 4:00	2	1	1	clear-night	35	0	Presidents' Day (regional holiday)
2/19/2018 5:00	9	7	2	clear-night	35	0	Presidents' Day (regional holiday)
2/19/2018 6:00	48	30	18	clear-night	34	0	Presidents' Day (regional holiday)
2/19/2018 7:00	109	45	64	clear-day	34	0	Presidents' Day (regional holiday)
2/19/2018 8:00	246	130	116	clear-day	37	0	Presidents' Day (regional holiday)
2/19/2018 9:00	489	279	210	clear-day	41	0	Presidents' Day (regional holiday)
2/19/2018 10:00	999	622	377	clear-day	44	0.0017	Presidents' Day (regional holiday)
2/19/2018 11:00	1624	781	843	clear-day	45	0.0022	Presidents' Day (regional holiday)
2/19/2018 12:00	1518	696	822	partly-cloudy-day	45	0.0012	Presidents' Day (regional holiday)
2/19/2018 13:00	1609	743	866	cloudy	45	0.0006	Presidents' Day (regional holiday)
2/19/2018 14:00	1559	717	842	cloudy	46	0.0003	Presidents' Day (regional holiday)
2/19/2018 15:00	1648	699	949	cloudy	47	0.0006	Presidents' Day (regional holiday)
2/19/2018 16:00	1242	539	703	partly-cloudy-day	47	0.0008	Presidents' Day (regional holiday)
2/19/2018 17:00	825	298	527	partly-cloudy-day	46	0.0013	Presidents' Day (regional holiday)
2/19/2018 18:00	198	137	61	cloudy	45	0.004	Presidents' Day (regional holiday)
2/19/2018 19:00	128	65	63	partly-cloudy-night	45	0.0108	Presidents' Day (regional holiday)
2/19/2018 20:00	98	60	38	partly-cloudy-night	45	0.0057	Presidents' Day (regional holiday)
2/19/2018 21:00	70	48	22	partly-cloudy-night	44	0.0089	Presidents' Day (regional holiday)
2/19/2018 22:00	71	47	24	fog	45	0.0066	Presidents' Day (regional holiday)
2/19/2018 23:00	53	39	14	fog	44	0.0029	Presidents' Day (regional holiday)
2/20/2018 0:00	29	21	8	fog	44	0.0028	
2/20/2018 1:00	15	10	5	fog	45	0.0004	
2/20/2018 2:00	5	3	2	fog	46	0.0002	
2/20/2018 3:00	4	2	2	cloudy	46	0	
2/20/2018 4:00	4	3	1	cloudy	47	0.0016	
2/20/2018 5:00	26	17	9	cloudy	47	0	
2/20/2018 6:00	108	74	34	fog	47	0	
2/20/2018 7:00	178	59	119	fog	48	0	
2/20/2018 8:00	232	77	155	fog	48	0	
2/20/2018 9:00	354	177	177	cloudy	49	0	
2/20/2018 10:00	849	494	355	cloudy	51	0.0006	
2/20/2018 11:00	1149	633	516	cloudy	52	0	
2/20/2018 12:00	1425	698	727	cloudy	56	0	
2/20/2018 13:00	1567	719	848	partly-cloudy-day	59	0	
2/20/2018 14:00	1661	746	915	clear-day	62	0	
2/20/2018 15:00	1747	811	936	clear-day	64	0	
2/20/2018 16:00	1912	1003	909	clear-day	66	0	
2/20/2018 17:00	1753	924	829	clear-day	65	0	
2/20/2018 18:00	995	476	519	clear-night	63	0	
2/20/2018 19:00	574	326	248	clear-night	60	0	
2/20/2018 20:00	416	249	167	clear-night	57	0	
2/20/2018 21:00	195	108	87	clear-night	57	0	
2/20/2018 22:00	138	66	72	clear-night	58	0	
2/20/2018 23:00	62	42	20	clear-night	57	0	
2/21/2018 0:00	39	18	21	partly-cloudy-night	57	0	
2/21/2018 1:00	4	3	1	partly-cloudy-night	55	0	
2/21/2018 2:00	6	4	2	partly-cloudy-night	54	0	
2/21/2018 3:00	5	0	5	partly-cloudy-night	53	0	
2/21/2018 4:00	5	3	2	cloudy	52	0	
2/21/2018 5:00	18	11	7	cloudy	56	0	
2/21/2018 6:00	101	51	50	cloudy	56	0	
2/21/2018 7:00	231	106	125	cloudy	58	0	
2/21/2018 8:00	325	104	221	cloudy	58	0	
2/21/2018 9:00	456	200	256	cloudy	59	0	
2/21/2018 10:00	787	448	339	partly-cloudy-day	62	0	
2/21/2018 11:00	1273	726	547	partly-cloudy-day	64	0	
2/21/2018 12:00	1559	745	814	clear-day	69	0	
2/21/2018 13:00	1743	836	907	clear-day	71	0	
2/21/2018 14:00	1804	883	921	clear-day	73	0	
2/21/2018 15:00	1807	848	959	clear-day	75	0	
2/21/2018 16:00	1952	997	955	clear-day	75	0	
2/21/2018 17:00	2131	1090	1041	clear-day	75	0	
2/21/2018 18:00	1250	580	670	clear-night	72	0	
2/21/2018 19:00	783	428	355	clear-night	70	0.0001	
2/21/2018 20:00	407	240	167	partly-cloudy-night	65	0.0106	
2/21/2018 21:00	215	151	64	rain	62	0.034	
2/21/2018 22:00	164	113	51	cloudy	59	0.021	
2/21/2018 23:00	140	112	28	cloudy	59	0.0019	
2/22/2018 0:00	33	19	14	cloudy	57	0	
2/22/2018 1:00	24	7	17	cloudy	56	0	
2/22/2018 2:00	8	6	2	cloudy	54	0	
2/22/2018 3:00	11	6	5	cloudy	52	0	
2/22/2018 4:00	8	7	1	cloudy	50	0.001	
2/22/2018 5:00	20	10	10	cloudy	48	0.0144	
2/22/2018 6:00	67	32	35	cloudy	46	0.016	
2/22/2018 7:00	105	38	67	cloudy	45	0.0009	
2/22/2018 8:00	192	60	132	partly-cloudy-day	44	0.0046	
2/22/2018 9:00	254	108	146	partly-cloudy-day	44	0.0135	
2/22/2018 10:00	551	285	266	partly-cloudy-day	44	0.0021	
2/22/2018 11:00	553	313	240	partly-cloudy-day	44	0.0015	
2/22/2018 12:00	711	364	347	partly-cloudy-day	44	0.0004	
2/22/2018 13:00	663	249	414	partly-cloudy-day	43	0.0013	
2/22/2018 14:00	533	260	273	partly-cloudy-day	42	0.0066	
2/22/2018 15:00	440	214	226	partly-cloudy-day	40	0.018	
2/22/2018 16:00	292	116	176	rain	39	0.0268	
2/22/2018 17:00	187	99	88	rain	38	0.0459	
2/22/2018 18:00	169	137	32	partly-cloudy-night	38	0.0225	
2/22/2018 19:00	107	79	28	partly-cloudy-night	38	0.002	
2/22/2018 20:00	213	169	44	partly-cloudy-night	38	0.0011	
2/22/2018 21:00	134	96	38	partly-cloudy-night	38	0.0003	
2/22/2018 22:00	151	124	27	partly-cloudy-night	37	0	
2/22/2018 23:00	60	46	14	partly-cloudy-night	38	0	
2/23/2018 0:00	20	10	10	partly-cloudy-night	37	0	
2/23/2018 1:00	10	5	5	cloudy	37	0	
2/23/2018 2:00	7	4	3	cloudy	36	0	
2/23/2018 3:00	2	1	1	cloudy	36	0	
2/23/2018 4:00	2	0	2	partly-cloudy-night	36	0.0002	
2/23/2018 5:00	19	15	4	partly-cloudy-night	36	0	
2/23/2018 6:00	69	30	39	partly-cloudy-night	36	0	
2/23/2018 7:00	126	59	67	partly-cloudy-day	36	0	
2/23/2018 8:00	177	62	115	cloudy	36	0.0001	
2/23/2018 9:00	257	117	140	cloudy	37	0	
2/23/2018 10:00	398	219	179	cloudy	37	0.0025	
2/23/2018 11:00	650	334	316	partly-cloudy-day	37	0.0063	
2/23/2018 12:00	736	386	350	partly-cloudy-day	38	0.0046	
2/23/2018 13:00	806	387	419	partly-cloudy-day	38	0.0018	
2/23/2018 14:00	767	368	399	partly-cloudy-day	39	0.0023	
2/23/2018 15:00	785	364	421	partly-cloudy-day	38	0.0057	
2/23/2018 16:00	692	319	373	cloudy	39	0.0067	
2/23/2018 17:00	468	253	215	cloudy	38	0.0051	
2/23/2018 18:00	148	109	39	cloudy	39	0.019	
2/23/2018 19:00	75	53	22	rain	39	0.0301	
2/23/2018 20:00	68	38	30	partly-cloudy-night	39	0.0015	
2/23/2018 21:00	59	42	17	cloudy	39	0.0003	
2/23/2018 22:00	48	31	17	cloudy	39	0.0009	
2/23/2018 23:00	43	30	13	cloudy	39	0	
2/24/2018 0:00	8	6	2	cloudy	40	0	
2/24/2018 1:00	9	7	2	partly-cloudy-night	41	0	
2/24/2018 2:00	7	6	1	partly-cloudy-night	42	0	
2/24/2018 3:00	0	0	0	partly-cloudy-night	42	0	
2/24/2018 4:00	6	3	3	partly-cloudy-night	42	0	
2/24/2018 5:00	7	5	2	partly-cloudy-night	42	0	
2/24/2018 6:00	37	27	10	partly-cloudy-night	42	0	
2/24/2018 7:00	98	48	50	partly-cloudy-day	43	0	
2/24/2018 8:00	213	128	85	partly-cloudy-day	45	0	
2/24/2018 9:00	648	345	303	clear-day	47	0	
2/24/2018 10:00	1320	751	569	clear-day	50	0	
2/24/2018 11:00	1821	935	886	cloudy	52	0	
2/24/2018 12:00	2127	1012	1115	partly-cloudy-day	52	0.0002	
2/24/2018 13:00	2047	897	1150	partly-cloudy-day	52	0.0003	
2/24/2018 14:00	1977	865	1112	partly-cloudy-day	52	0.0002	
2/24/2018 15:00	1165	469	696	partly-cloudy-day	51	0.0002	
2/24/2018 16:00	794	408	386	partly-cloudy-day	47	0.014	
2/24/2018 17:00	800	377	423	partly-cloudy-day	46	0.0088	
2/24/2018 18:00	451	279	172	partly-cloudy-night	46	0.0084	
2/24/2018 19:00	241	143	98	cloudy	46	0.0026	
2/24/2018 20:00	116	65	51	partly-cloudy-night	45	0.0059	
2/24/2018 21:00	84	65	19	partly-cloudy-night	45	0.0032	
2/24/2018 22:00	107	102	5	partly-cloudy-night	44	0.0031	
2/24/2018 23:00	99	90	9	partly-cloudy-night	44	0.003	
2/25/2018 0:00	96	89	7	partly-cloudy-night	43	0.0018	
2/25/2018 1:00	10	4	6	partly-cloudy-night	43	0	
2/25/2018 2:00	9	7	2	partly-cloudy-night	43	0.0001	
2/25/2018 3:00	7	5	2	partly-cloudy-night	43	0	
2/25/2018 4:00	2	0	2	partly-cloudy-night	42	0.0193	
2/25/2018 5:00	2	1	1	rain	42	0.1129	
2/25/2018 6:00	6	4	2	rain	42	0.4543	
2/25/2018 7:00	17	10	7	rain	42	0.3316	
2/25/2018 8:00	39	20	19	rain	41	0.0772	
2/25/2018 9:00	113	72	41	rain	41	0.0429	
2/25/2018 10:00	314	170	144	rain	42	0.0384	
2/25/2018 11:00	249	146	103	rain	42	0.0448	
2/25/2018 12:00	421	204	217	rain	42	0.0344	
2/25/2018 13:00	509	265	244	partly-cloudy-day	42	0.0065	
2/25/2018 14:00	773	431	342	partly-cloudy-day	42	0.0023	
2/25/2018 15:00	873	444	429	partly-cloudy-day	42	0.0018	
2/25/2018 16:00	885	467	418	cloudy	42	0	
2/25/2018 17:00	751	378	373	cloudy	42	0.0022	
2/25/2018 18:00	268	147	121	cloudy	42	0.0006	
2/25/2018 19:00	210	125	85	cloudy	42	0.0003	
2/25/2018 20:00	141	63	78	cloudy	43	0.0001	
2/25/2018 21:00	78	37	41	cloudy	42	0	
2/25/2018 22:00	60	30	30	cloudy	42	0	
2/25/2018 23:00	31	18	13	partly-cloudy-night	42	0	
2/26/2018 0:00	14	7	7	partly-cloudy-night	42	0	
2/26/2018 1:00	8	4	4	partly-cloudy-night	42	0	
2/26/2018 2:00	4	1	3	partly-cloudy-night	43	0	
2/26/2018 3:00	4	3	1	partly-cloudy-night	42	0	
2/26/2018 4:00	5	3	2	clear-night	42	0	
2/26/2018 5:00	19	13	6	clear-night	42	0	
2/26/2018 6:00	85	45	40	clear-night	43	0.0003	
2/26/2018 7:00	157	64	93	clear-day	44	0	
2/26/2018 8:00	329	131	198	clear-day	44	0	
2/26/2018 9:00	417	182	235	clear-day	44	0	
2/26/2018 10:00	808	462	346	partly-cloudy-day	44	0	
2/26/2018 11:00	1517	801	716	partly-cloudy-day	45	0	
2/26/2018 12:00	1342	585	757	partly-cloudy-day	46	0	
2/26/2018 13:00	1224	583	641	partly-cloudy-day	47	0	
2/26/2018 14:00	1442	753	689	clear-day	49	0	
2/26/2018 15:00	1433	746	687	clear-day	50	0	
2/26/2018 16:00	1584	830	754	clear-day	51	0.0025	
2/26/2018 17:00	1423	857	566	clear-day	50	0	
2/26/2018 18:00	811	404	407	clear-night	49	0	
2/26/2018 19:00	401	255	146	clear-night	46	0	
2/26/2018 20:00	283	185	98	clear-night	44	0.0018	
2/26/2018 21:00	132	75	57	clear-night	44	0	
2/26/2018 22:00	127	52	75	clear-night	43	0	
2/26/2018 23:00	74	20	54	clear-night	42	0	
2/27/2018 0:00	27	10	17	clear-night	42	0	
2/27/2018 1:00	9	8	1	clear-night	41	0	
2/27/2018 2:00	4	2	2	clear-night	40	0	
2/27/2018 3:00	3	0	3	clear-night	39	0	
2/27/2018 4:00	2	1	1	clear-night	38	0	
2/27/2018 5:00	28	16	12	clear-night	37	0	
2/27/2018 6:00	97	49	48	clear-night	37	0	
2/27/2018 7:00	196	90	106	clear-day	37	0	
2/27/2018 8:00	320	127	193	clear-day	40	0	
2/27/2018 9:00	448	235	213	clear-day	43	0.0024	
2/27/2018 10:00	888	478	410	clear-day	46	0	
2/27/2018 11:00	1065	500	565	clear-day	48	0.0007	
2/27/2018 12:00	1177	554	623	clear-day	51	0.0019	
2/27/2018 13:00	1343	600	743	clear-day	53	0.0016	
2/27/2018 14:00	1498	650	848	clear-day	54	0	
2/27/2018 15:00	1402	715	687	clear-day	55	0	
2/27/2018 16:00	1485	680	805	clear-day	54	0.0024	
2/27/2018 17:00	1264	637	627	clear-day	52	0	
2/27/2018 18:00	796	414	382	clear-night	49	0	
2/27/2018 19:00	398	265	133	clear-night	46	0	
2/27/2018 20:00	269	188	81	clear-night	46	0	
2/27/2018 21:00	199	148	51	clear-night	44	0	
2/27/2018 22:00	82	52	30	clear-night	44	0	
2/27/2018 23:00	36	20	16	clear-night	43	0	
2/28/2018 0:00	7	0	7	clear-night	42	0	
2/28/2018 1:00	14	7	7	clear-night	41	0	
2/28/2018 2:00	4	2	2	clear-night	41	0	
2/28/2018 3:00	1	0	1	clear-night	40	0	
2/28/2018 4:00	13	9	4	clear-night	40	0	
2/28/2018 5:00	20	10	10	clear-night	39	0	
2/28/2018 6:00	123	74	49	clear-night	38	0	
2/28/2018 7:00	177	70	107	clear-day	38	0	
2/28/2018 8:00	351	120	231	clear-day	40	0.0046	
2/28/2018 9:00	415	207	208	clear-day	42	0.0013	
2/28/2018 10:00	644	348	296	clear-day	46	0	
2/28/2018 11:00	994	457	537	clear-day	48	0.001	
2/28/2018 12:00	1031	424	607	clear-day	51	0	
2/28/2018 13:00	1089	551	538	clear-day	54	0.0055	
2/28/2018 14:00	1149	572	577	clear-day	58	0	
2/28/2018 15:00	1092	525	567	clear-day	59	0	
2/28/2018 16:00	1178	560	618	clear-day	60	0	
2/28/2018 17:00	1233	651	582	clear-day	58	0	
2/28/2018 18:00	782	368	414	clear-night	55	0	
2/28/2018 19:00	435	250	185	clear-night	53	0	
2/28/2018 20:00	346	228	118	clear-night	53	0	
2/28/2018 21:00	156	91	65	partly-cloudy-night	53	0	
2/28/2018 22:00	90	53	37	partly-cloudy-night	53	0	
2/28/2018 23:00	104	64	40	partly-cloudy-night	52	0	
3/1/2018 0:00	35	22	13	partly-cloudy-night	52	0	
3/1/2018 1:00	9	2	7	partly-cloudy-night	51	0	
3/1/2018 2:00	6	3	3	partly-cloudy-night	50	0	
3/1/2018 3:00	11	8	3	partly-cloudy-night	49	0	
3/1/2018 4:00	5	3	2	clear-night	47	0	
3/1/2018 5:00	28	14	14	clear-night	46	0	
3/1/2018 6:00	106	53	53	clear-night	46	0	
3/1/2018 7:00	169	84	85	clear-day	45	0	
3/1/2018 8:00	276	90	186	clear-day	46	0	
3/1/2018 9:00	353	171	182	clear-day	49	0	
3/1/2018 10:00	521	292	229	clear-day	54	0	
3/1/2018 11:00	764	413	351	clear-day	56	0.0008	
3/1/2018 12:00	961	465	496	clear-day	57	0	
3/1/2018 13:00	907	399	508	clear-day	57	0	
3/1/2018 14:00	1008	467	541	clear-day	58	0	
3/1/2018 15:00	971	471	500	clear-day	56	0	
3/1/2018 16:00	1182	543	639	clear-day	55	0.0018	
3/1/2018 17:00	832	431	401	clear-day	54	0	
3/1/2018 18:00	548	344	204	partly-cloudy-night	53	0	
3/1/2018 19:00	259	142	117	partly-cloudy-night	52	0	
3/1/2018 20:00	131	94	37	partly-cloudy-night	50	0	
3/1/2018 21:00	23	16	7	partly-cloudy-night	48	0.0026	
3/1/2018 22:00	18	15	3	rain	45	0.0661	
3/1/2018 23:00	13	11	2	rain	44	0.2712	
3/2/2018 0:00	1	0	1	rain	44	0.0819	
3/2/2018 1:00	0	0	0	rain	43	0.0865	
3/2/2018 2:00	0	0	0	rain	43	0.2612	
3/2/2018 3:00	3	1	2	rain	42	0.3027	
3/2/2018 4:00	0	0	0	rain	43	0.1125	
3/2/2018 5:00	3	2	1	rain	41	0.0828	
3/2/2018 6:00	16	11	5	rain	39	0.0444	
3/2/2018 7:00	18	7	11	rain	37	0.055	
3/2/2018 8:00	41	16	25	rain	36	0.0661	
3/2/2018 9:00	44	18	26	rain	35	0.291	
3/2/2018 10:00	51	28	23	rain	35	0.1035	
3/2/2018 11:00	58	28	30	rain	36	0.0797	
3/2/2018 12:00	53	28	25	rain	36	0.0821	
3/2/2018 13:00	22	8	14	rain	36	0.0923	
3/2/2018 14:00	39	24	15	rain	36	0.0655	
3/2/2018 15:00	18	12	6	rain	35	0.0343	
3/2/2018 16:00	39	26	13	rain	35	0.0285	
3/2/2018 17:00	46	31	15	partly-cloudy-day	34	0.0231	
3/2/2018 18:00	33	31	2	rain	34	0.2134	
3/2/2018 19:00	14	13	1	partly-cloudy-night	34	0.0204	
3/2/2018 20:00	13	8	5	partly-cloudy-night	35	0.0085	
3/2/2018 21:00	16	9	7	partly-cloudy-night	35	0.0024	
3/2/2018 22:00	14	5	9	partly-cloudy-night	36	0.0011	
3/2/2018 23:00	11	4	7	partly-cloudy-night	36	0.0006	
3/3/2018 0:00	16	10	6	partly-cloudy-night	36	0.0004	
3/3/2018 1:00	8	2	6	partly-cloudy-night	36	0	
3/3/2018 2:00	0	0	0	partly-cloudy-night	36	0	
3/3/2018 3:00	3	2	1	partly-cloudy-night	36	0.0001	
3/3/2018 4:00	2	1	1	partly-cloudy-night	36	0.0008	
3/3/2018 5:00	4	0	4	partly-cloudy-night	36	0	
3/3/2018 6:00	26	11	15	partly-cloudy-night	37	0	
3/3/2018 7:00	75	36	39	partly-cloudy-day	37	0	
3/3/2018 8:00	188	94	94	clear-day	37	0	
3/3/2018 9:00	488	285	203	clear-day	38	0.0001	
3/3/2018 10:00	1022	503	519	clear-day	41	0.005	
3/3/2018 11:00	1480	746	734	clear-day	43	0.005	
3/3/2018 12:00	1665	786	879	clear-day	45	0.0063	
3/3/2018 13:00	1945	893	1052	clear-day	46	0.0059	
3/3/2018 14:00	1981	990	991	clear-day	45	0.004	
3/3/2018 15:00	2147	990	1157	partly-cloudy-day	46	0.003	
3/3/2018 16:00	1852	844	1008	partly-cloudy-day	45	0.0025	
3/3/2018 17:00	1462	722	740	partly-cloudy-day	43	0.0011	
3/3/2018 18:00	754	337	417	partly-cloudy-night	42	0.0008	
3/3/2018 19:00	403	178	225	cloudy	42	0.0007	
3/3/2018 20:00	208	102	106	cloudy	41	0.0003	
3/3/2018 21:00	120	52	68	partly-cloudy-night	41	0.0005	
3/3/2018 22:00	70	39	31	partly-cloudy-night	41	0.0002	
3/3/2018 23:00	100	72	28	partly-cloudy-night	41	0.0005	
3/4/2018 0:00	36	26	10	cloudy	40	0.0002	
3/4/2018 1:00	21	10	11	partly-cloudy-night	40	0.0001	
3/4/2018 2:00	12	9	3	partly-cloudy-night	40	0	
3/4/2018 3:00	7	6	1	partly-cloudy-night	39	0	
3/4/2018 4:00	4	0	4	partly-cloudy-night	40	0.0001	
3/4/2018 5:00	7	5	2	partly-cloudy-night	39	0.0001	
3/4/2018 6:00	50	34	16	cloudy	39	0.0003	
3/4/2018 7:00	96	44	52	cloudy	39	0.0001	
3/4/2018 8:00	190	100	90	cloudy	39	0	
3/4/2018 9:00	584	371	213	cloudy	40	0.0001	
3/4/2018 10:00	888	505	383	cloudy	41	0.0001	
3/4/2018 11:00	1380	674	706	partly-cloudy-day	41	0.0002	
3/4/2018 12:00	1363	670	693	partly-cloudy-day	42	0.0002	
3/4/2018 13:00	1648	775	873	partly-cloudy-day	42	0.0002	
3/4/2018 14:00	1643	733	910	partly-cloudy-day	42	0.0003	
3/4/2018 15:00	1684	825	859	partly-cloudy-day	43	0.0002	
3/4/2018 16:00	1652	757	895	partly-cloudy-day	43	0	
3/4/2018 17:00	1439	628	811	partly-cloudy-day	42	0.0001	
3/4/2018 18:00	840	339	501	partly-cloudy-night	39	0	
3/4/2018 19:00	405	238	167	partly-cloudy-night	38	0	
3/4/2018 20:00	200	130	70	partly-cloudy-night	36	0	
3/4/2018 21:00	107	50	57	partly-cloudy-night	35	0	
3/4/2018 22:00	46	22	24	clear-night	34	0	
3/4/2018 23:00	30	16	14	partly-cloudy-night	33	0	
3/5/2018 0:00	9	4	5	partly-cloudy-night	33	0	
3/5/2018 1:00	13	7	6	partly-cloudy-night	33	0	
3/5/2018 2:00	1	0	1	partly-cloudy-night	33	0	
3/5/2018 3:00	0	0	0	partly-cloudy-night	33	0	
3/5/2018 4:00	4	2	2	partly-cloudy-night	33	0	
3/5/2018 5:00	11	7	4	partly-cloudy-night	33	0	
3/5/2018 6:00	64	33	31	partly-cloudy-night	33	0	
3/5/2018 7:00	123	57	66	partly-cloudy-day	33	0	
3/5/2018 8:00	261	101	160	clear-day	35	0	
3/5/2018 9:00	433	227	206	partly-cloudy-day	37	0	
3/5/2018 10:00	801	424	377	partly-cloudy-day	39	0	
3/5/2018 11:00	1301	639	662	partly-cloudy-day	40	0	
3/5/2018 12:00	1258	593	665	partly-cloudy-day	40	0	
3/5/2018 13:00	1208	556	652	partly-cloudy-day	40	0	
3/5/2018 14:00	1323	600	723	cloudy	41	0	
3/5/2018 15:00	1287	576	711	cloudy	41	0	
3/5/2018 16:00	1151	539	612	cloudy	42	0	
3/5/2018 17:00	1275	681	594	cloudy	42	0.002	
3/5/2018 18:00	817	419	398	partly-cloudy-night	40	0	
3/5/2018 19:00	319	158	161	partly-cloudy-night	39	0	
3/5/2018 20:00	181	72	109	clear-night	38	0	
3/5/2018 21:00	100	48	52	clear-night	37	0	
3/5/2018 22:00	49	24	25	clear-night	36	0	
3/5/2018 23:00	43	20	23	clear-night	35	0	
3/6/2018 0:00	11	5	6	clear-night	35	0	
3/6/2018 1:00	3	2	1	clear-night	34	0	
3/6/2018 2:00	4	2	2	clear-night	34	0	
3/6/2018 3:00	9	4	5	clear-night	33	0	
3/6/2018 4:00	4	1	3	clear-night	32	0	
3/6/2018 5:00	18	10	8	clear-night	32	0	
3/6/2018 6:00	105	64	41	clear-night	31	0	
3/6/2018 7:00	153	72	81	clear-day	32	0	
3/6/2018 8:00	265	90	175	clear-day	36	0	
3/6/2018 9:00	468	254	214	clear-day	39	0	
3/6/2018 10:00	871	534	337	clear-day	40	0	
3/6/2018 11:00	1240	527	713	clear-day	42	0	
3/6/2018 12:00	1211	557	654	clear-day	44	0	
3/6/2018 13:00	1482	620	862	clear-day	44	0	
3/6/2018 14:00	1364	639	725	clear-day	44	0	
3/6/2018 15:00	1527	726	801	clear-day	44	0	
3/6/2018 16:00	1573	762	811	clear-day	43	0	
3/6/2018 17:00	1391	603	788	partly-cloudy-day	41	0	
3/6/2018 18:00	759	364	395	partly-cloudy-night	40	0	
3/6/2018 19:00	321	185	136	partly-cloudy-night	39	0	
3/6/2018 20:00	272	187	85	partly-cloudy-night	39	0	
3/6/2018 21:00	190	129	61	partly-cloudy-night	39	0	
3/6/2018 22:00	109	94	15	partly-cloudy-night	39	0	
3/6/2018 23:00	18	13	5	partly-cloudy-night	39	0	
3/7/2018 0:00	20	15	5	partly-cloudy-night	38	0	
3/7/2018 1:00	3	1	2	partly-cloudy-night	37	0	
3/7/2018 2:00	0	0	0	partly-cloudy-night	36	0.0038	
3/7/2018 3:00	0	0	0	partly-cloudy-night	34	0.013	
3/7/2018 4:00	1	0	1	partly-cloudy-night	34	0.0151	
3/7/2018 5:00	13	0	13	partly-cloudy-night	34	0.0079	
3/7/2018 6:00	29	14	15	partly-cloudy-night	34	0.0041	
3/7/2018 7:00	57	16	41	partly-cloudy-day	34	0.0052	
3/7/2018 8:00	80	28	52	partly-cloudy-day	35	0.0073	
3/7/2018 9:00	105	54	51	partly-cloudy-day	35	0.0075	
3/7/2018 10:00	203	99	104	partly-cloudy-day	36	0.0139	
3/7/2018 11:00	208	86	122	partly-cloudy-day	36	0.0176	
3/7/2018 12:00	89	47	42	partly-cloudy-day	35	0.0199	
3/7/2018 13:00	46	19	27	sleet	33	0.0358	
3/7/2018 14:00	112	44	68	sleet	34	0.0462	
3/7/2018 15:00	41	28	13	rain	34	0.037	
3/7/2018 16:00	46	29	17	sleet	33	0.0704	
3/7/2018 17:00	46	30	16	snow	32	0.0805	
3/7/2018 18:00	18	10	8	snow	33	0.0654	
3/7/2018 19:00	10	6	4	snow	33	0.0461	
3/7/2018 20:00	3	2	1	sleet	33	0.0593	
3/7/2018 21:00	8	7	1	sleet	33	0.2284	
3/7/2018 22:00	2	0	2	partly-cloudy-night	34	0.0189	
3/7/2018 23:00	6	1	5	partly-cloudy-night	34	0.0126	
3/8/2018 0:00	1	0	1	partly-cloudy-night	34	0.0037	
3/8/2018 1:00	6	4	2	partly-cloudy-night	34	0.0034	
3/8/2018 2:00	2	0	2	partly-cloudy-night	34	0.0027	
3/8/2018 3:00	0	0	0	partly-cloudy-night	34	0.005	
3/8/2018 4:00	0	0	0	clear-night	33	0.0021	
3/8/2018 5:00	4	2	2	clear-night	32	0.0014	
3/8/2018 6:00	37	22	15	clear-night	33	0.0018	
3/8/2018 7:00	62	24	38	partly-cloudy-day	33	0.0006	
3/8/2018 8:00	168	63	105	clear-day	35	0.0017	
3/8/2018 9:00	385	213	172	clear-day	37	0.0054	
3/8/2018 10:00	799	430	369	partly-cloudy-day	37	0.007	
3/8/2018 11:00	944	408	536	partly-cloudy-day	38	0.0179	
3/8/2018 12:00	1049	463	586	partly-cloudy-day	38	0.0221	
3/8/2018 13:00	958	423	535	rain	38	0.0296	
3/8/2018 14:00	1031	495	536	rain	38	0.0286	
3/8/2018 15:00	1059	453	606	snow	39	0.0281	
3/8/2018 16:00	1089	544	545	snow	38	0.0235	
3/8/2018 17:00	860	445	415	snow	38	0.0102	
3/8/2018 18:00	459	193	266	partly-cloudy-night	37	0.0037	
3/8/2018 19:00	163	63	100	partly-cloudy-night	36	0.0038	
3/8/2018 20:00	151	89	62	partly-cloudy-night	36	0.0006	
3/8/2018 21:00	125	80	45	partly-cloudy-night	35	0.003	
3/8/2018 22:00	76	46	30	partly-cloudy-night	34	0.0005	
3/8/2018 23:00	30	14	16	partly-cloudy-night	33	0	
3/9/2018 0:00	11	5	6	partly-cloudy-night	33	0	
3/9/2018 1:00	3	2	1	partly-cloudy-night	32	0.0007	
3/9/2018 2:00	4	0	4	partly-cloudy-night	31	0	
3/9/2018 3:00	2	1	1	partly-cloudy-night	31	0	
3/9/2018 4:00	3	0	3	partly-cloudy-night	30	0	
3/9/2018 5:00	16	11	5	partly-cloudy-night	29	0	
3/9/2018 6:00	60	22	38	partly-cloudy-night	29	0	
3/9/2018 7:00	124	55	69	partly-cloudy-day	29	0	
3/9/2018 8:00	229	94	135	partly-cloudy-day	31	0	
3/9/2018 9:00	359	211	148	partly-cloudy-day	33	0	
3/9/2018 10:00	834	432	402	partly-cloudy-day	35	0.0013	
3/9/2018 11:00	1007	501	506	partly-cloudy-day	36	0.0029	
3/9/2018 12:00	1222	571	651	partly-cloudy-day	37	0.009	
3/9/2018 13:00	1220	520	700	partly-cloudy-day	39	0.0109	
3/9/2018 14:00	1370	613	757	partly-cloudy-day	41	0.0115	
3/9/2018 15:00	1362	614	748	partly-cloudy-day	41	0.0151	
3/9/2018 16:00	1414	643	771	partly-cloudy-day	41	0.0154	
3/9/2018 17:00	1082	573	509	clear-day	41	0.0088	
3/9/2018 18:00	553	248	305	partly-cloudy-night	39	0.0049	
3/9/2018 19:00	256	125	131	clear-night	38	0.0004	
3/9/2018 20:00	149	82	67	clear-night	37	0	
3/9/2018 21:00	112	69	43	clear-night	36	0.0002	
3/9/2018 22:00	86	50	36	clear-night	35	0	
3/9/2018 23:00	36	26	10	clear-night	34	0	
3/10/2018 0:00	55	45	10	clear-night	34	0	
3/10/2018 1:00	38	28	10	partly-cloudy-night	34	0	
3/10/2018 2:00	5	4	1	partly-cloudy-night	33	0	
3/10/2018 3:00	5	3	2	clear-night	33	0	
3/10/2018 4:00	3	1	2	clear-night	32	0	
3/10/2018 5:00	4	4	0	clear-night	31	0	
3/10/2018 6:00	43	21	22	clear-night	31	0	
3/10/2018 7:00	93	51	42	clear-day	31	0	
3/10/2018 8:00	228	123	105	clear-day	33	0.0001	
3/10/2018 9:00	952	351	601	clear-day	35	0	
3/10/2018 10:00	1143	636	507	clear-day	36	0.0015	
3/10/2018 11:00	1465	762	703	partly-cloudy-day	37	0.0033	
3/10/2018 12:00	1854	883	971	partly-cloudy-day	38	0.0031	
3/10/2018 13:00	2156	1023	1133	partly-cloudy-day	39	0.0023	
3/10/2018 14:00	2183	979	1204	partly-cloudy-day	39	0.0041	
3/10/2018 15:00	2119	993	1126	cloudy	38	0.0024	
3/10/2018 16:00	1852	844	1008	cloudy	38	0.0022	
3/10/2018 17:00	1755	861	894	cloudy	38	0.0012	
3/10/2018 18:00	888	331	557	cloudy	38	0.0006	
3/10/2018 19:00	423	199	224	cloudy	38	0.0002	
3/10/2018 20:00	331	173	158	cloudy	37	0	
3/10/2018 21:00	166	74	92	partly-cloudy-night	37	0	
3/10/2018 22:00	167	117	50	partly-cloudy-night	36	0	
3/10/2018 23:00	171	131	40	partly-cloudy-night	35	0	
3/11/2018 0:00	139	118	21	clear-night	34	0	Daylight Saving Time starts
3/11/2018 1:00	50	24	26	partly-cloudy-night	34	0	Daylight Saving Time starts
3/11/2018 2:00	0	0	0				Daylight Saving Time starts
3/11/2018 3:00	5	3	2	partly-cloudy-night	33	0	Daylight Saving Time starts
3/11/2018 4:00	6	4	2	partly-cloudy-night	33	0	Daylight Saving Time starts
3/11/2018 5:00	25	17	8	partly-cloudy-night	32	0	Daylight Saving Time starts
3/11/2018 6:00	72	36	36	clear-night	32	0	Daylight Saving Time starts
3/11/2018 7:00	146	77	69	clear-night	31	0	Daylight Saving Time starts
3/11/2018 8:00	357	237	120	clear-day	32	0	Daylight Saving Time starts
3/11/2018 9:00	794	486	308	clear-day	34	0	Daylight Saving Time starts
3/11/2018 10:00	1270	659	611	clear-day	36	0	Daylight Saving Time starts
3/11/2018 11:00	1675	892	783	clear-day	37	0	Daylight Saving Time starts
3/11/2018 12:00	1931	930	1001	clear-day	38	0.003	Daylight Saving Time starts
3/11/2018 13:00	2073	1065	1008	clear-day	41	0.0058	Daylight Saving Time starts
3/11/2018 14:00	2176	996	1180	clear-day	42	0.004	Daylight Saving Time starts
3/11/2018 15:00	2232	1136	1096	clear-day	43	0.0056	Daylight Saving Time starts
3/11/2018 16:00	2212	1017	1195	clear-day	43	0.0045	Daylight Saving Time starts
3/11/2018 17:00	1712	793	919	clear-day	44	0.0025	Daylight Saving Time starts
3/11/2018 18:00	969	368	601	clear-day	44	0.0009	Daylight Saving Time starts
3/11/2018 19:00	430	223	207	clear-night	42	0.0002	Daylight Saving Time starts
3/11/2018 20:00	275	157	118	clear-night	40	0.0001	Daylight Saving Time starts
3/11/2018 21:00	123	50	73	clear-night	39	0	Daylight Saving Time starts
3/11/2018 22:00	68	26	42	clear-night	38	0	Daylight Saving Time starts
3/11/2018 23:00	35	11	24	clear-night	37	0	Daylight Saving Time starts
3/12/2018 0:00	35	11	24	clear-night	36	0	
3/12/2018 1:00	15	4	11	clear-night	35	0	
3/12/2018 2:00	11	8	3	clear-night	34	0	
3/12/2018 3:00	5	0	5	clear-night	33	0	
3/12/2018 4:00	1	0	1	clear-night	32	0	
3/12/2018 5:00	9	3	6	clear-night	32	0	
3/12/2018 6:00	48	29	19	clear-night	31	0	
3/12/2018 7:00	123	58	65	clear-night	31	0	
3/12/2018 8:00	188	69	119	clear-day	32	0	
3/12/2018 9:00	323	178	145	clear-day	35	0	
3/12/2018 10:00	757	381	376	clear-day	37	0	
3/12/2018 11:00	1062	550	512	clear-day	38	0	
3/12/2018 12:00	1267	598	669	clear-day	41	0.0007	
3/12/2018 13:00	1328	617	711	clear-day	42	0.0007	
3/12/2018 14:00	1411	637	774	clear-day	42	0.0015	
3/12/2018 15:00	1535	687	848	partly-cloudy-day	42	0.0003	
3/12/2018 16:00	1295	636	659	partly-cloudy-day	41	0.0002	
3/12/2018 17:00	1418	722	696	partly-cloudy-day	41	0.0002	
3/12/2018 18:00	885	465	420	partly-cloudy-day	41	0	
3/12/2018 19:00	444	213	231	partly-cloudy-night	41	0.0002	
3/12/2018 20:00	280	143	137	partly-cloudy-night	40	0.0002	
3/12/2018 21:00	163	73	90	partly-cloudy-night	40	0	
3/12/2018 22:00	52	19	33	partly-cloudy-night	38	0.0001	
3/12/2018 23:00	11	6	5	partly-cloudy-night	36	0.0028	
3/13/2018 0:00	3	1	2	partly-cloudy-night	35	0.0074	
3/13/2018 1:00	3	2	1	partly-cloudy-night	35	0.0125	
3/13/2018 2:00	0	0	0	partly-cloudy-night	35	0.0089	
3/13/2018 3:00	1	0	1	partly-cloudy-night	34	0.0044	
3/13/2018 4:00	0	0	0	partly-cloudy-night	33	0.0086	
3/13/2018 5:00	1	0	1	partly-cloudy-night	33	0.007	
3/13/2018 6:00	10	3	7	sleet	33	0.1982	
3/13/2018 7:00	34	13	21	snow	33	0.0146	
3/13/2018 8:00	70	25	45	snow	33	0.0142	
3/13/2018 9:00	82	37	45	partly-cloudy-day	34	0.0103	
3/13/2018 10:00	144	96	48	partly-cloudy-day	34	0.0067	
3/13/2018 11:00	315	153	162	partly-cloudy-day	35	0.0059	
3/13/2018 12:00	312	152	160	snow	35	0.0094	
3/13/2018 13:00	374	197	177	rain	36	0.2245	
3/13/2018 14:00	539	275	264	partly-cloudy-day	38	0.0104	
3/13/2018 15:00	739	392	347	rain	39	0.2387	
3/13/2018 16:00	796	436	360	partly-cloudy-day	39	0.0084	
3/13/2018 17:00	774	375	399	partly-cloudy-day	40	0.0025	
3/13/2018 18:00	654	380	274	clear-day	39	0.0008	
3/13/2018 19:00	444	207	237	partly-cloudy-night	37	0.0002	
3/13/2018 20:00	207	93	114	clear-night	36	0	
3/13/2018 21:00	89	40	49	clear-night	35	0	
3/13/2018 22:00	76	44	32	clear-night	35	0	
3/13/2018 23:00	41	14	27	partly-cloudy-night	34	0	
3/14/2018 0:00	28	19	9	clear-night	34	0	
3/14/2018 1:00	11	5	6	clear-night	33	0	
3/14/2018 2:00	1	0	1	clear-night	32	0	
3/14/2018 3:00	0	0	0	clear-night	32	0	
3/14/2018 4:00	2	1	1	partly-cloudy-night	32	0	
3/14/2018 5:00	7	2	5	clear-night	31	0	
3/14/2018 6:00	57	37	20	partly-cloudy-night	31	0	
3/14/2018 7:00	136	62	74	clear-night	31	0	
3/14/2018 8:00	199	78	121	clear-day	31	0	
3/14/2018 9:00	363	187	176	clear-day	32	0	
3/14/2018 10:00	785	404	381	clear-day	34	0	
3/14/2018 11:00	974	523	451	clear-day	35	0	
3/14/2018 12:00	1202	444	758	clear-day	37	0	
3/14/2018 13:00	1223	568	655	clear-day	38	0	
3/14/2018 14:00	1335	571	764	partly-cloudy-day	39	0.0002	
3/14/2018 15:00	1441	632	809	partly-cloudy-day	39	0	
3/14/2018 16:00	1152	570	582	partly-cloudy-day	39	0	
3/14/2018 17:00	997	471	526	partly-cloudy-day	38	0.0064	
3/14/2018 18:00	703	390	313	partly-cloudy-day	37	0	
3/14/2018 19:00	414	221	193	partly-cloudy-night	36	0	
3/14/2018 20:00	270	193	77	partly-cloudy-night	34	0.0007	
3/14/2018 21:00	173	117	56	partly-cloudy-night	34	0.001	
3/14/2018 22:00	71	48	23	partly-cloudy-night	34	0.001	
3/14/2018 23:00	67	53	14	partly-cloudy-night	33	0.0011	
3/15/2018 0:00	30	10	20	partly-cloudy-night	33	0.0007	
3/15/2018 1:00	6	2	4	partly-cloudy-night	33	0	
3/15/2018 2:00	7	1	6	partly-cloudy-night	33	0	
3/15/2018 3:00	0	0	0	partly-cloudy-night	33	0	
3/15/2018 4:00	1	0	1	partly-cloudy-night	32	0	
3/15/2018 5:00	6	4	2	partly-cloudy-night	32	0	
3/15/2018 6:00	37	20	17	clear-night	32	0	
3/15/2018 7:00	130	70	60	clear-night	32	0	
3/15/2018 8:00	197	80	117	partly-cloudy-day	33	0	
3/15/2018 9:00	354	166	188	clear-day	34	0	
3/15/2018 10:00	740	358	382	clear-day	36	0	
3/15/2018 11:00	1013	527	486	clear-day	38	0	
3/15/2018 12:00	1382	617	765	clear-day	41	0	
3/15/2018 13:00	1492	629	863	clear-day	43	0	
3/15/2018 14:00	1578	711	867	clear-day	44	0	
3/15/2018 15:00	1553	695	858	clear-day	46	0	
3/15/2018 16:00	1700	872	828	partly-cloudy-day	46	0	
3/15/2018 17:00	1445	691	754	partly-cloudy-day	44	0	
3/15/2018 18:00	1153	654	499	partly-cloudy-day	42	0	
3/15/2018 19:00	651	297	354	partly-cloudy-night	41	0	
3/15/2018 20:00	328	179	149	partly-cloudy-night	40	0	
3/15/2018 21:00	240	169	71	partly-cloudy-night	38	0	
3/15/2018 22:00	162	121	41	partly-cloudy-night	37	0	
3/15/2018 23:00	83	56	27	clear-night	36	0	
3/16/2018 0:00	40	27	13	clear-night	36	0	
3/16/2018 1:00	6	1	5	clear-night	35	0	
3/16/2018 2:00	1	0	1	clear-night	35	0	
3/16/2018 3:00	2	0	2	clear-night	34	0	
3/16/2018 4:00	5	4	1	clear-night	34	0	
3/16/2018 5:00	16	9	7	clear-night	33	0	
3/16/2018 6:00	80	48	32	clear-night	33	0	
3/16/2018 7:00	145	54	91	clear-night	33	0	
3/16/2018 8:00	205	99	106	clear-day	34	0	
3/16/2018 9:00	328	173	155	clear-day	35	0	
3/16/2018 10:00	858	421	437	partly-cloudy-day	36	0	
3/16/2018 11:00	1216	528	688	partly-cloudy-day	37	0	
3/16/2018 12:00	1352	673	679	partly-cloudy-day	38	0	
3/16/2018 13:00	1492	689	803	partly-cloudy-day	38	0.0017	
3/16/2018 14:00	1413	632	781	partly-cloudy-day	39	0	
3/16/2018 15:00	1496	697	799	partly-cloudy-day	39	0	
3/16/2018 16:00	1339	583	756	partly-cloudy-day	38	0	
3/16/2018 17:00	1236	627	609	partly-cloudy-day	38	0.0017	
3/16/2018 18:00	912	429	483	partly-cloudy-day	36	0	
3/16/2018 19:00	554	248	306	clear-night	35	0	
3/16/2018 20:00	267	125	142	clear-night	34	0	
3/16/2018 21:00	238	164	74	clear-night	33	0	
3/16/2018 22:00	75	45	30	clear-night	32	0	
3/16/2018 23:00	127	99	28	clear-night	32	0	
3/17/2018 0:00	107	99	8	clear-night	31	0	St. Patrick's Day
3/17/2018 1:00	18	13	5	clear-night	30	0	St. Patrick's Day
3/17/2018 2:00	9	2	7	clear-night	30	0	St. Patrick's Day
3/17/2018 3:00	1	1	0	clear-night	29	0	St. Patrick's Day
3/17/2018 4:00	0	0	0	clear-night	28	0	St. Patrick's Day
3/17/2018 5:00	3	1	2	clear-night	28	0	St. Patrick's Day
3/17/2018 6:00	35	24	11	clear-night	28	0	St. Patrick's Day
3/17/2018 7:00	103	54	49	clear-night	27	0	St. Patrick's Day
3/17/2018 8:00	147	72	75	clear-day	28	0	St. Patrick's Day
3/17/2018 9:00	424	281	143	clear-day	30	0	St. Patrick's Day
3/17/2018 10:00	847	463	384	clear-day	33	0	St. Patrick's Day
3/17/2018 11:00	1364	563	801	clear-day	35	0	St. Patrick's Day
3/17/2018 12:00	1555	735	820	clear-day	38	0	St. Patrick's Day
3/17/2018 13:00	1859	795	1064	clear-day	42	0	St. Patrick's Day
3/17/2018 14:00	1983	925	1058	clear-day	44	0	St. Patrick's Day
3/17/2018 15:00	2300	1028	1272	clear-day	46	0	St. Patrick's Day
3/17/2018 16:00	1954	844	1110	clear-day	46	0	St. Patrick's Day
3/17/2018 17:00	1738	911	827	clear-day	47	0	St. Patrick's Day
3/17/2018 18:00	1285	556	729	clear-day	47	0	St. Patrick's Day
3/17/2018 19:00	973	366	607	clear-day	46	0	St. Patrick's Day
3/17/2018 20:00	408	159	249	clear-night	44	0	St. Patrick's Day
3/17/2018 21:00	233	101	132	clear-night	43	0	St. Patrick's Day
3/17/2018 22:00	163	99	64	clear-night	41	0	St. Patrick's Day
3/17/2018 23:00	68	24	44	clear-night	39	0	St. Patrick's Day
3/18/2018 0:00	42	21	21	clear-night	37	0	
3/18/2018 1:00	27	17	10	clear-night	36	0	
3/18/2018 2:00	8	6	2	clear-night	35	0	
3/18/2018 3:00	10	4	6	clear-night	34	0	
3/18/2018 4:00	3	0	3	clear-night	33	0	
3/18/2018 5:00	3	2	1	clear-night	32	0	
3/18/2018 6:00	34	23	11	clear-night	31	0	
3/18/2018 7:00	78	37	41	clear-night	29	0	
3/18/2018 8:00	185	106	79	clear-day	29	0	
3/18/2018 9:00	381	235	146	clear-day	28	0	
3/18/2018 10:00	822	517	305	clear-day	30	0	
3/18/2018 11:00	1359	684	675	clear-day	31	0	
3/18/2018 12:00	1598	725	873	clear-day	34	0	
3/18/2018 13:00	1820	804	1016	clear-day	36	0	
3/18/2018 14:00	1905	865	1040	clear-day	39	0	
3/18/2018 15:00	1944	980	964	clear-day	40	0	
3/18/2018 16:00	1834	836	998	clear-day	42	0.0017	
3/18/2018 17:00	1591	742	849	clear-day	43	0	
3/18/2018 18:00	1352	642	710	clear-day	43	0	
3/18/2018 19:00	895	339	556	clear-day	42	0	
3/18/2018 20:00	466	237	229	clear-night	40	0	
3/18/2018 21:00	223	110	113	clear-night	39	0	
3/18/2018 22:00	123	73	50	clear-night	38	0	
3/18/2018 23:00	56	14	42	clear-night	37	0	
3/19/2018 0:00	32	11	21	clear-night	35	0	
3/19/2018 1:00	1	0	1	clear-night	34	0	
3/19/2018 2:00	1	0	1	clear-night	34	0	
3/19/2018 3:00	2	0	2	clear-night	34	0	
3/19/2018 4:00	2	1	1	clear-night	33	0	
3/19/2018 5:00	13	6	7	clear-night	33	0	
3/19/2018 6:00	55	31	24	clear-night	31	0	
3/19/2018 7:00	132	54	78	clear-night	32	0	
3/19/2018 8:00	273	94	179	clear-day	33	0	
3/19/2018 9:00	313	163	150	clear-day	35	0	
3/19/2018 10:00	648	378	270	clear-day	36	0	
3/19/2018 11:00	1022	495	527	clear-day	38	0	
3/19/2018 12:00	1262	545	717	clear-day	40	0	
3/19/2018 13:00	1310	618	692	clear-day	42	0	
3/19/2018 14:00	1365	654	711	clear-day	43	0	
3/19/2018 15:00	1538	696	842	clear-day	44	0	
3/19/2018 16:00	1315	601	714	clear-day	45	0	
3/19/2018 17:00	1366	737	629	clear-day	45	0	
3/19/2018 18:00	1120	601	519	clear-day	45	0	
3/19/2018 19:00	637	264	373	clear-day	43	0	
3/19/2018 20:00	261	109	152	clear-night	41	0	
3/19/2018 21:00	157	74	83	clear-night	39	0	
3/19/2018 22:00	58	23	35	clear-night	38	0	
3/19/2018 23:00	32	16	16	clear-night	36	0	
3/20/2018 0:00	20	15	5	clear-night	35	0	
3/20/2018 1:00	13	4	9	clear-night	34	0	
3/20/2018 2:00	10	6	4	clear-night	34	0	
3/20/2018 3:00	10	7	3	clear-night	33	0	
3/20/2018 4:00	1	0	1	clear-night	32	0	
3/20/2018 5:00	13	8	5	clear-night	31	0	
3/20/2018 6:00	62	35	27	clear-night	31	0	
3/20/2018 7:00	139	57	82	clear-night	31	0	
3/20/2018 8:00	194	64	130	clear-day	31	0	
3/20/2018 9:00	244	115	129	clear-day	32	0	
3/20/2018 10:00	481	230	251	clear-day	32	0	
3/20/2018 11:00	653	297	356	clear-day	32	0	
3/20/2018 12:00	781	373	408	partly-cloudy-day	34	0	
3/20/2018 13:00	774	358	416	partly-cloudy-day	35	0	
3/20/2018 14:00	717	305	412	partly-cloudy-day	35	0	
3/20/2018 15:00	895	414	481	partly-cloudy-day	36	0	
3/20/2018 16:00	717	370	347	partly-cloudy-day	37	0	
3/20/2018 17:00	617	318	299	partly-cloudy-day	37	0.0002	
3/20/2018 18:00	494	282	212	partly-cloudy-day	37	0.0008	
3/20/2018 19:00	216	109	107	partly-cloudy-day	37	0.0012	
3/20/2018 20:00	129	98	31	partly-cloudy-night	38	0.0012	
3/20/2018 21:00	104	68	36	partly-cloudy-night	38	0	
3/20/2018 22:00	46	29	17	partly-cloudy-night	38	0	
3/20/2018 23:00	29	12	17	partly-cloudy-night	37	0	
3/21/2018 0:00	21	15	6	partly-cloudy-night	37	0	
3/21/2018 1:00	10	8	2	cloudy	38	0	
3/21/2018 2:00	2	0	2	cloudy	38	0	
3/21/2018 3:00	2	1	1	cloudy	38	0	
3/21/2018 4:00	0	0	0	cloudy	38	0	
3/21/2018 5:00	7	4	3	partly-cloudy-night	37	0.0001	
3/21/2018 6:00	22	10	12	partly-cloudy-night	36	0	
3/21/2018 7:00	38	11	27	partly-cloudy-night	34	0.0001	
3/21/2018 8:00	67	22	45	partly-cloudy-day	33	0.0014	
3/21/2018 9:00	30	11	19	fog	32	0.0041	
3/21/2018 10:00	77	42	35	snow	31	0.0128	
3/21/2018 11:00	94	48	46	snow	31	0.017	
3/21/2018 12:00	130	62	68	snow	32	0.0113	
3/21/2018 13:00	147	88	59	snow	32	0.0116	
3/21/2018 14:00	167	109	58	snow	32	0.0168	
3/21/2018 15:00	202	117	85	snow	32	0.0144	
3/21/2018 16:00	183	105	78	snow	32	0.0137	
3/21/2018 17:00	133	82	51	snow	32	0.0119	
3/21/2018 18:00	107	64	43	snow	32	0.0132	
3/21/2018 19:00	67	24	43	snow	32	0.0144	
3/21/2018 20:00	37	17	20	snow	32	0.0168	
3/21/2018 21:00	32	12	20	snow	32	0.016	
3/21/2018 22:00	19	7	12	snow	32	0.2029	
3/21/2018 23:00	7	5	2	snow	32	0.0225	
3/22/2018 0:00	5	1	4	snow	32	0.0205	
3/22/2018 1:00	2	1	1	snow	32	0.0149	
3/22/2018 2:00	2	0	2	snow	32	0.0091	
3/22/2018 3:00	0	0	0	partly-cloudy-night	32	0.0027	
3/22/2018 4:00	0	0	0	partly-cloudy-night	32	0.0059	
3/22/2018 5:00	2	1	1	partly-cloudy-night	32	0.0068	
3/22/2018 6:00	8	6	2	partly-cloudy-night	33	0.0011	
3/22/2018 7:00	42	26	16	partly-cloudy-night	33	0	
3/22/2018 8:00	104	29	75	partly-cloudy-day	34	0.0026	
3/22/2018 9:00	193	86	107	partly-cloudy-day	36	0.0001	
3/22/2018 10:00	601	377	224	partly-cloudy-day	38	0.0039	
3/22/2018 11:00	801	429	372	clear-day	40	0.0152	
3/22/2018 12:00	1008	582	426	rain	43	0.0325	
3/22/2018 13:00	1246	565	681	rain	44	0.0435	
3/22/2018 14:00	1163	463	700	clear-day	45	0.0114	
3/22/2018 15:00	1515	798	717	clear-day	47	0.0074	
3/22/2018 16:00	1170	590	580	clear-day	48	0.0015	
3/22/2018 17:00	1175	629	546	clear-day	50	0.0004	
3/22/2018 18:00	1030	510	520	clear-day	50	0	
3/22/2018 19:00	513	231	282	clear-day	47	0	
3/22/2018 20:00	228	126	102	clear-night	45	0	
3/22/2018 21:00	116	42	74	clear-night	43	0.0064	
3/22/2018 22:00	66	29	37	clear-night	42	0	
3/22/2018 23:00	33	12	21	clear-night	41	0	
3/23/2018 0:00	19	13	6	clear-night	39	0	
3/23/2018 1:00	3	0	3	clear-night	38	0	
3/23/2018 2:00	6	3	3	clear-night	37	0	
3/23/2018 3:00	0	0	0	clear-night	36	0	
3/23/2018 4:00	3	2	1	clear-night	36	0	
3/23/2018 5:00	7	2	5	clear-night	35	0	
3/23/2018 6:00	51	31	20	clear-night	35	0	
3/23/2018 7:00	176	48	128	clear-day	34	0	
3/23/2018 8:00	209	80	129	clear-day	35	0	
3/23/2018 9:00	557	302	255	clear-day	37	0	
3/23/2018 10:00	1001	518	483	clear-day	39	0	
3/23/2018 11:00	1357	678	679	clear-day	42	0	
3/23/2018 12:00	1409	658	751	clear-day	44	0	
3/23/2018 13:00	1517	679	838	clear-day	46	0	
3/23/2018 14:00	1668	741	927	clear-day	48	0	
3/23/2018 15:00	1835	842	993	partly-cloudy-day	48	0	
3/23/2018 16:00	1635	714	921	partly-cloudy-day	47	0	
3/23/2018 17:00	1389	617	772	partly-cloudy-day	47	0	
3/23/2018 18:00	850	474	376	partly-cloudy-day	46	0	
3/23/2018 19:00	574	279	295	partly-cloudy-day	45	0	
3/23/2018 20:00	360	209	151	partly-cloudy-night	44	0	
3/23/2018 21:00	229	124	105	partly-cloudy-night	43	0	
3/23/2018 22:00	108	50	58	partly-cloudy-night	42	0	
3/23/2018 23:00	105	78	27	partly-cloudy-night	41	0	
3/24/2018 0:00	20	0	20	partly-cloudy-night	40	0	
3/24/2018 1:00	20	12	8	partly-cloudy-night	38	0	
3/24/2018 2:00	12	7	5	partly-cloudy-night	37	0	
3/24/2018 3:00	4	1	3	partly-cloudy-night	37	0	
3/24/2018 4:00	2	0	2	partly-cloudy-night	36	0	
3/24/2018 5:00	11	6	5	clear-night	35	0	
3/24/2018 6:00	72	56	16	clear-night	35	0	
3/24/2018 7:00	136	55	81	clear-day	34	0	
3/24/2018 8:00	160	82	78	clear-day	35	0	
3/24/2018 9:00	650	315	335	clear-day	38	0	
3/24/2018 10:00	1269	684	585	clear-day	41	0	
3/24/2018 11:00	1831	1021	810	clear-day	44	0	
3/24/2018 12:00	2234	1064	1170	clear-day	45	0	
3/24/2018 13:00	2707	1282	1425	clear-day	47	0	
3/24/2018 14:00	2615	1229	1386	clear-day	48	0	
3/24/2018 15:00	3088	1564	1524	clear-day	48	0	
3/24/2018 16:00	2625	1209	1416	clear-day	49	0	
3/24/2018 17:00	2121	1008	1113	clear-day	49	0	
3/24/2018 18:00	1839	832	1007	clear-day	48	0	
3/24/2018 19:00	1147	440	707	clear-day	46	0	
3/24/2018 20:00	493	207	286	partly-cloudy-night	45	0	
3/24/2018 21:00	229	107	122	partly-cloudy-night	43	0	
3/24/2018 22:00	178	96	82	partly-cloudy-night	42	0	
3/24/2018 23:00	239	192	47	partly-cloudy-night	41	0	
3/25/2018 0:00	125	98	27	partly-cloudy-night	39	0	
3/25/2018 1:00	22	16	6	clear-night	38	0	
3/25/2018 2:00	11	4	7	partly-cloudy-night	37	0	
3/25/2018 3:00	5	4	1	clear-night	35	0	
3/25/2018 4:00	4	1	3	clear-night	34	0	
3/25/2018 5:00	13	6	7	clear-night	34	0	
3/25/2018 6:00	50	39	11	clear-night	34	0	
3/25/2018 7:00	79	36	43	clear-day	34	0	
3/25/2018 8:00	163	85	78	partly-cloudy-day	35	0	
3/25/2018 9:00	582	310	272	partly-cloudy-day	36	0	
3/25/2018 10:00	1057	667	390	partly-cloudy-day	38	0	
3/25/2018 11:00	1615	948	667	partly-cloudy-day	40	0	
3/25/2018 12:00	1548	737	811	partly-cloudy-day	41	0	
3/25/2018 13:00	1817	829	988	partly-cloudy-day	41	0	
3/25/2018 14:00	1931	889	1042	partly-cloudy-day	42	0	
3/25/2018 15:00	1976	916	1060	partly-cloudy-day	42	0	
3/25/2018 16:00	1857	744	1113	partly-cloudy-day	42	0	
3/25/2018 17:00	1767	681	1086	partly-cloudy-day	42	0	
3/25/2018 18:00	1396	575	821	partly-cloudy-day	42	0	
3/25/2018 19:00	917	379	538	clear-day	41	0	
3/25/2018 20:00	495	246	249	partly-cloudy-night	40	0	
3/25/2018 21:00	284	142	142	partly-cloudy-night	39	0	
3/25/2018 22:00	75	38	37	partly-cloudy-night	38	0	
3/25/2018 23:00	43	11	32	partly-cloudy-night	38	0	
3/26/2018 0:00	15	9	6	clear-night	36	0	
3/26/2018 1:00	15	7	8	clear-night	35	0	
3/26/2018 2:00	2	1	1	clear-night	35	0	
3/26/2018 3:00	1	0	1	clear-night	34	0	
3/26/2018 4:00	4	2	2	clear-night	34	0	
3/26/2018 5:00	10	7	3	clear-night	29	0	
3/26/2018 6:00	56	34	22	clear-night	33	0	
3/26/2018 7:00	153	79	74	clear-day	32	0	
3/26/2018 8:00	288	120	168	clear-day	35	0	
3/26/2018 9:00	537	276	261	clear-day	38	0	
3/26/2018 10:00	1231	601	630	clear-day	39	0	
3/26/2018 11:00	1762	899	863	clear-day	41	0	
3/26/2018 12:00	1969	882	1087	clear-day	42	0	
3/26/2018 13:00	2175	950	1225	clear-day	44	0	
3/26/2018 14:00	2032	945	1087	clear-day	45	0	
3/26/2018 15:00	2515	1226	1289	clear-day	46	0	
3/26/2018 16:00	2251	1106	1145	clear-day	45	0	
3/26/2018 17:00	2029	1034	995	clear-day	46	0	
3/26/2018 18:00	1899	1015	884	clear-day	44	0	
3/26/2018 19:00	1030	414	616	clear-day	41	0	
3/26/2018 20:00	405	156	249	clear-night	39	0	
3/26/2018 21:00	162	62	100	clear-night	38	0	
3/26/2018 22:00	120	53	67	clear-night	38	0	
3/26/2018 23:00	53	36	17	clear-night	37	0	
3/27/2018 0:00	22	10	12	clear-night	36	0	
3/27/2018 1:00	1	0	1	clear-night	35	0	
3/27/2018 2:00	1	0	1	clear-night	35	0	
3/27/2018 3:00	5	3	2	clear-night	34	0	
3/27/2018 4:00	4	0	4	clear-night	34	0	
3/27/2018 5:00	22	10	12	clear-night	33	0	
3/27/2018 6:00	99	53	46	clear-night	33	0	
3/27/2018 7:00	183	74	109	clear-day	33	0	
3/27/2018 8:00	289	95	194	clear-day	34	0	
3/27/2018 9:00	460	254	206	clear-day	37	0	
3/27/2018 10:00	991	520	471	clear-day	38	0	
3/27/2018 11:00	1559	743	816	clear-day	40	0	
3/27/2018 12:00	1769	779	990	clear-day	41	0	
3/27/2018 13:00	1941	830	1111	clear-day	41	0	
3/27/2018 14:00	1841	724	1117	clear-day	42	0	
3/27/2018 15:00	1999	826	1173	clear-day	41	0	
3/27/2018 16:00	1809	772	1037	clear-day	40	0	
3/27/2018 17:00	1431	679	752	clear-day	40	0	
3/27/2018 18:00	1140	603	537	partly-cloudy-day	40	0	
3/27/2018 19:00	637	294	343	partly-cloudy-day	40	0	
3/27/2018 20:00	354	137	217	partly-cloudy-night	39	0	
3/27/2018 21:00	224	114	110	partly-cloudy-night	39	0	
3/27/2018 22:00	170	141	29	partly-cloudy-night	39	0	
3/27/2018 23:00	101	88	13	partly-cloudy-night	38	0.0012	
3/28/2018 0:00	11	8	3	cloudy	38	0.0017	
3/28/2018 1:00	3	0	3	partly-cloudy-night	37	0.0048	
3/28/2018 2:00	6	3	3	partly-cloudy-night	36	0.0054	
3/28/2018 3:00	0	0	0	partly-cloudy-night	37	0.0003	
3/28/2018 4:00	4	2	2	partly-cloudy-night	37	0	
3/28/2018 5:00	12	10	2	partly-cloudy-night	37	0.0014	
3/28/2018 6:00	48	28	20	partly-cloudy-night	37	0.0134	
3/28/2018 7:00	117	52	65	partly-cloudy-day	37	0.0037	
3/28/2018 8:00	301	118	183	partly-cloudy-day	38	0.0035	
3/28/2018 9:00	392	191	201	partly-cloudy-day	39	0	
3/28/2018 10:00	743	418	325	partly-cloudy-day	40	0	
3/28/2018 11:00	1247	639	608	partly-cloudy-day	42	0.0004	
3/28/2018 12:00	1531	700	831	partly-cloudy-day	44	0	
3/28/2018 13:00	1682	824	858	partly-cloudy-day	46	0	
3/28/2018 14:00	1699	711	988	partly-cloudy-day	47	0	
3/28/2018 15:00	1865	844	1021	partly-cloudy-day	48	0	
3/28/2018 16:00	1557	719	838	partly-cloudy-day	48	0	
3/28/2018 17:00	1543	767	776	partly-cloudy-day	49	0	
3/28/2018 18:00	1343	687	656	partly-cloudy-day	48	0	
3/28/2018 19:00	811	394	417	partly-cloudy-day	47	0	
3/28/2018 20:00	551	283	268	partly-cloudy-night	47	0.0027	
3/28/2018 21:00	292	140	152	partly-cloudy-night	46	0	
3/28/2018 22:00	124	62	62	partly-cloudy-night	46	0	
3/28/2018 23:00	72	37	35	partly-cloudy-night	46	0	
3/29/2018 0:00	58	8	50	partly-cloudy-night	47	0	
3/29/2018 1:00	25	5	20	cloudy	46	0	
3/29/2018 2:00	9	7	2	cloudy	46	0	
3/29/2018 3:00	9	4	5	cloudy	46	0	
3/29/2018 4:00	7	4	3	partly-cloudy-night	47	0	
3/29/2018 5:00	24	15	9	partly-cloudy-night	46	0.0002	
3/29/2018 6:00	75	34	41	partly-cloudy-night	46	0	
3/29/2018 7:00	202	59	143	partly-cloudy-day	47	0	
3/29/2018 8:00	284	75	209	partly-cloudy-day	47	0.0015	
3/29/2018 9:00	347	171	176	partly-cloudy-day	46	0.0054	
3/29/2018 10:00	580	294	286	fog	46	0.007	
3/29/2018 11:00	867	491	376	partly-cloudy-day	48	0.0064	
3/29/2018 12:00	1188	687	501	partly-cloudy-day	48	0.0023	
3/29/2018 13:00	1443	728	715	cloudy	48	0	
3/29/2018 14:00	1801	775	1026	cloudy	48	0.0018	
3/29/2018 15:00	1759	791	968	cloudy	49	0	
3/29/2018 16:00	1709	788	921	cloudy	49	0	
3/29/2018 17:00	1449	639	810	cloudy	49	0	
3/29/2018 18:00	1123	494	629	cloudy	49	0	
3/29/2018 19:00	494	271	223	fog	48	0	
3/29/2018 20:00	232	154	78	fog	48	0	
3/29/2018 21:00	207	147	60	fog	47	0	
3/29/2018 22:00	177	136	41	cloudy	46	0	
3/29/2018 23:00	150	117	33	cloudy	46	0	
3/30/2018 0:00	103	89	14	cloudy	47	0	
3/30/2018 1:00	16	11	5	partly-cloudy-night	47	0.0004	
3/30/2018 2:00	12	7	5	partly-cloudy-night	47	0.003	
3/30/2018 3:00	8	5	3	partly-cloudy-night	48	0	
3/30/2018 4:00	9	5	4	partly-cloudy-night	47	0	
3/30/2018 5:00	12	9	3	partly-cloudy-night	47	0.0002	
3/30/2018 6:00	49	26	23	partly-cloudy-night	47	0.0021	
3/30/2018 7:00	117	58	59	partly-cloudy-day	48	0.0019	
3/30/2018 8:00	260	135	125	partly-cloudy-day	50	0.0003	
3/30/2018 9:00	445	222	223	partly-cloudy-day	52	0.0006	
3/30/2018 10:00	1190	710	480	partly-cloudy-day	53	0.0004	
3/30/2018 11:00	2334	733	1601	partly-cloudy-day	55	0.0004	
3/30/2018 12:00	2077	956	1121	partly-cloudy-day	56	0.0027	
3/30/2018 13:00	2331	1077	1254	partly-cloudy-day	56	0	
3/30/2018 14:00	2434	1121	1313	partly-cloudy-day	57	0.0004	
3/30/2018 15:00	2747	1391	1356	partly-cloudy-day	58	0	
3/30/2018 16:00	1891	623	1268	partly-cloudy-day	56	0	
3/30/2018 17:00	911	400	511	partly-cloudy-day	52	0.0051	
3/30/2018 18:00	904	486	418	partly-cloudy-day	51	0.0092	
3/30/2018 19:00	694	340	354	rain	49	0.2061	
3/30/2018 20:00	483	215	268	partly-cloudy-night	48	0.0009	
3/30/2018 21:00	240	107	133	partly-cloudy-night	48	0	
3/30/2018 22:00	194	84	110	partly-cloudy-night	46	0	
3/30/2018 23:00	126	67	59	clear-night	45	0.0002	
3/31/2018 0:00	55	21	34	clear-night	44	0.0012	
3/31/2018 1:00	25	10	15	clear-night	43	0.0003	
3/31/2018 2:00	5	3	2	partly-cloudy-night	42	0	
3/31/2018 3:00	9	6	3	partly-cloudy-night	41	0	
3/31/2018 4:00	7	3	4	partly-cloudy-night	41	0	
3/31/2018 5:00	15	9	6	partly-cloudy-night	39	0	
3/31/2018 6:00	98	70	28	clear-night	38	0	
3/31/2018 7:00	145	60	85	clear-day	38	0	
3/31/2018 8:00	366	212	154	clear-day	39	0	
3/31/2018 9:00	1101	649	452	clear-day	42	0.0003	
3/31/2018 10:00	2167	1272	895	clear-day	44	0	
3/31/2018 11:00	3420	1828	1592	clear-day	47	0	
3/31/2018 12:00	4058	1980	2078	clear-day	50	0	
3/31/2018 13:00	4210	2062	2148	clear-day	51	0	
3/31/2018 14:00	3989	2185	1804	clear-day	54	0	
3/31/2018 15:00	4001	1975	2026	clear-day	54	0	
3/31/2018 16:00	2686	505	2181	clear-day	53	0	
3/31/2018 17:00	3372	1681	1691	clear-day	50	0	
3/31/2018 18:00	2969	1373	1596	clear-day	49	0	
3/31/2018 19:00	1826	696	1130	clear-day	48	0	
3/31/2018 20:00	791	325	466	clear-night	46	0	
3/31/2018 21:00	374	185	189	clear-night	47	0	
3/31/2018 22:00	260	166	94	clear-night	46	0	
3/31/2018 23:00	278	195	83	clear-night	44	0	
4/1/2018 0:00	61	22	39	clear-night	44	0	Easter Sunday
4/1/2018 1:00	10	6	4	clear-night	43	0	Easter Sunday
4/1/2018 2:00	8	5	3	clear-night	43	0	Easter Sunday
4/1/2018 3:00	3	1	2	partly-cloudy-night	44	0	Easter Sunday
4/1/2018 4:00	4	2	2	partly-cloudy-night	44	0	Easter Sunday
4/1/2018 5:00	15	8	7	partly-cloudy-night	44	0	Easter Sunday
4/1/2018 6:00	74	62	12	partly-cloudy-night	44	0	Easter Sunday
4/1/2018 7:00	153	63	90	partly-cloudy-day	45	0	Easter Sunday
4/1/2018 8:00	298	174	124	partly-cloudy-day	46	0	Easter Sunday
4/1/2018 9:00	850	480	370	partly-cloudy-day	48	0	Easter Sunday
4/1/2018 10:00	1508	888	620	clear-day	50	0	Easter Sunday
4/1/2018 11:00	2245	1160	1085	clear-day	53	0	Easter Sunday
4/1/2018 12:00	2775	1456	1319	clear-day	56	0	Easter Sunday
4/1/2018 13:00	2982	1418	1564	clear-day	57	0.0017	Easter Sunday
4/1/2018 14:00	3180	1492	1688	partly-cloudy-day	57	0	Easter Sunday
4/1/2018 15:00	3491	1783	1708	partly-cloudy-day	56	0	Easter Sunday
4/1/2018 16:00	3092	1499	1593	partly-cloudy-day	55	0	Easter Sunday
4/1/2018 17:00	2800	1183	1617	partly-cloudy-day	55	0	Easter Sunday
4/1/2018 18:00	2235	1004	1231	clear-day	54	0	Easter Sunday
4/1/2018 19:00	1777	669	1108	clear-day	53	0	Easter Sunday
4/1/2018 20:00	643	246	397	clear-night	50	0	Easter Sunday
4/1/2018 21:00	357	113	244	clear-night	48	0	Easter Sunday
4/1/2018 22:00	167	60	107	clear-night	46	0	Easter Sunday
4/1/2018 23:00	102	38	64	clear-night	44	0	Easter Sunday
4/2/2018 0:00	26	16	10	clear-night	43	0	
4/2/2018 1:00	5	2	3	partly-cloudy-night	42	0	
4/2/2018 2:00	9	3	6	partly-cloudy-night	42	0	
4/2/2018 3:00	3	3	0	cloudy	41	0	
4/2/2018 4:00	6	5	1	partly-cloudy-night	41	0.0003	
4/2/2018 5:00	2	1	1	partly-cloudy-night	35	0.0053	
4/2/2018 6:00	17	10	7	snow	33	0.0223	
4/2/2018 7:00	25	13	12	snow	32	0.038	
4/2/2018 8:00	41	13	28	snow	32	0.0366	
4/2/2018 9:00	97	57	40	snow	33	0.0237	
4/2/2018 10:00	333	247	86	snow	33	0.0149	
4/2/2018 11:00	568	357	211	snow	34	0.0103	
4/2/2018 12:00	823	450	373	snow	35	0.0093	
4/2/2018 13:00	1014	510	504	partly-cloudy-day	37	0.0061	
4/2/2018 14:00	1208	572	636	partly-cloudy-day	37	0.0122	
4/2/2018 15:00	1363	696	667	rain	38	0.0395	
4/2/2018 16:00	1701	882	819	rain	40	0.0533	
4/2/2018 17:00	1674	791	883	partly-cloudy-day	41	0.0186	
4/2/2018 18:00	1374	651	723	rain	41	0.2139	
4/2/2018 19:00	859	400	459	clear-day	40	0.0032	
4/2/2018 20:00	418	188	230	clear-night	39	0.0005	
4/2/2018 21:00	228	99	129	clear-night	38	0.0005	
4/2/2018 22:00	69	30	39	clear-night	38	0.0006	
4/2/2018 23:00	39	16	23	clear-night	37	0	
4/3/2018 0:00	21	11	10	clear-night	36	0	
4/3/2018 1:00	13	7	6	clear-night	36	0	
4/3/2018 2:00	4	3	1	clear-night	36	0	
4/3/2018 3:00	6	2	4	clear-night	36	0	
4/3/2018 4:00	4	2	2	clear-night	36	0	
4/3/2018 5:00	9	5	4	clear-night	36	0	
4/3/2018 6:00	49	29	20	partly-cloudy-night	36	0	
4/3/2018 7:00	152	61	91	partly-cloudy-day	37	0	
4/3/2018 8:00	234	87	147	partly-cloudy-day	38	0	
4/3/2018 9:00	531	279	252	partly-cloudy-day	39	0	
4/3/2018 10:00	1337	736	601	partly-cloudy-day	40	0.0004	
4/3/2018 11:00	1211	485	726	partly-cloudy-day	40	0.001	
4/3/2018 12:00	644	230	414	partly-cloudy-day	39	0.0157	
4/3/2018 13:00	544	238	306	rain	39	0.0437	
4/3/2018 14:00	564	264	300	rain	40	0.0416	
4/3/2018 15:00	466	205	261	rain	40	0.0273	
4/3/2018 16:00	477	252	225	partly-cloudy-day	41	0.0207	
4/3/2018 17:00	341	225	116	fog	41	0.0192	
4/3/2018 18:00	349	193	156	fog	41	0.0162	
4/3/2018 19:00	215	136	79	cloudy	41	0.003	
4/3/2018 20:00	86	62	24	cloudy	40	0.0032	
4/3/2018 21:00	51	34	17	cloudy	40	0.0017	
4/3/2018 22:00	26	19	7	cloudy	40	0.0003	
4/3/2018 23:00	28	13	15	cloudy	40	0	
4/4/2018 0:00	9	8	1	cloudy	40	0.0004	
4/4/2018 1:00	4	0	4	cloudy	40	0.0006	
4/4/2018 2:00	4	3	1	cloudy	41	0.0027	
4/4/2018 3:00	1	0	1	cloudy	41	0.0005	
4/4/2018 4:00	0	0	0	fog	41	0.0002	
4/4/2018 5:00	2	1	1	cloudy	41	0	
4/4/2018 6:00	58	25	33	fog	42	0.0007	
4/4/2018 7:00	126	45	81	fog	43	0.0026	
4/4/2018 8:00	220	82	138	fog	44	0.0034	
4/4/2018 9:00	443	198	245	fog	46	0.0007	
4/4/2018 10:00	739	440	299	fog	47	0	
4/4/2018 11:00	1289	673	616	cloudy	49	0.0004	
4/4/2018 12:00	1670	784	886	partly-cloudy-day	51	0.0007	
4/4/2018 13:00	954	366	588	partly-cloudy-day	53	0.0007	
4/4/2018 14:00	854	517	337	partly-cloudy-day	52	0.019	
4/4/2018 15:00	1385	671	714	partly-cloudy-day	53	0.0085	
4/4/2018 16:00	1546	843	703	partly-cloudy-day	54	0.0019	
4/4/2018 17:00	1765	864	901	partly-cloudy-day	54	0.0008	
4/4/2018 18:00	1507	748	759	partly-cloudy-day	52	0	
4/4/2018 19:00	1029	486	543	clear-day	49	0	
4/4/2018 20:00	527	247	280	clear-night	47	0.0018	
4/4/2018 21:00	215	86	129	clear-night	45	0	
4/4/2018 22:00	131	77	54	clear-night	44	0	
4/4/2018 23:00	88	67	21	clear-night	42	0	
4/5/2018 0:00	7	4	3	clear-night	40	0	
4/5/2018 1:00	3	2	1	clear-night	39	0	
4/5/2018 2:00	10	9	1	clear-night	38	0	
4/5/2018 3:00	4	2	2	clear-night	37	0	
4/5/2018 4:00	5	2	3	partly-cloudy-night	36	0	
4/5/2018 5:00	13	10	3	clear-night	35	0	
4/5/2018 6:00	109	65	44	clear-night	34	0	
4/5/2018 7:00	150	69	81	clear-day	33	0	
4/5/2018 8:00	312	148	164	clear-day	34	0	
4/5/2018 9:00	668	373	295	clear-day	35	0.0004	
4/5/2018 10:00	1742	1041	701	clear-day	37	0	
4/5/2018 11:00	2693	1196	1497	clear-day	38	0	
4/5/2018 12:00	2847	1304	1543	partly-cloudy-day	40	0	
4/5/2018 13:00	2945	1227	1718	partly-cloudy-day	41	0.004	
4/5/2018 14:00	2874	1231	1643	partly-cloudy-day	42	0	
4/5/2018 15:00	2774	1220	1554	partly-cloudy-day	43	0	
4/5/2018 16:00	2552	1048	1504	partly-cloudy-day	43	0	
4/5/2018 17:00	2107	977	1130	partly-cloudy-day	44	0	
4/5/2018 18:00	1622	741	881	partly-cloudy-day	44	0	
4/5/2018 19:00	1082	448	634	partly-cloudy-day	42	0	
4/5/2018 20:00	503	181	322	clear-night	41	0	
4/5/2018 21:00	200	103	97	clear-night	40	0	
4/5/2018 22:00	119	54	65	clear-night	39	0	
4/5/2018 23:00	83	42	41	clear-night	37	0	
4/6/2018 0:00	18	10	8	clear-night	36	0	
4/6/2018 1:00	6	5	1	clear-night	36	0	
4/6/2018 2:00	9	3	6	clear-night	36	0	
4/6/2018 3:00	3	2	1	clear-night	35	0	
4/6/2018 4:00	4	1	3	clear-night	35	0	
4/6/2018 5:00	11	4	7	partly-cloudy-night	35	0	
4/6/2018 6:00	53	27	26	partly-cloudy-night	36	0	
4/6/2018 7:00	141	37	104	partly-cloudy-day	37	0	
4/6/2018 8:00	111	47	64	partly-cloudy-day	37	0	
4/6/2018 9:00	105	42	63	partly-cloudy-day	36	0.004	
4/6/2018 10:00	342	226	116	partly-cloudy-day	37	0.0142	
4/6/2018 11:00	749	416	333	partly-cloudy-day	40	0.0133	
4/6/2018 12:00	1110	573	537	partly-cloudy-day	43	0.0043	
4/6/2018 13:00	1441	710	731	partly-cloudy-day	46	0.0016	
4/6/2018 14:00	1770	885	885	partly-cloudy-day	48	0	
4/6/2018 15:00	2031	913	1118	partly-cloudy-day	53	0	
4/6/2018 16:00	1718	745	973	clear-day	56	0	
4/6/2018 17:00	1886	891	995	clear-day	59	0	
4/6/2018 18:00	1533	668	865	partly-cloudy-day	59	0.0002	
4/6/2018 19:00	930	421	509	partly-cloudy-day	57	0	
4/6/2018 20:00	480	233	247	partly-cloudy-night	55	0.0012	
4/6/2018 21:00	278	130	148	partly-cloudy-night	54	0	
4/6/2018 22:00	179	102	77	partly-cloudy-night	53	0.0033	
4/6/2018 23:00	117	60	57	partly-cloudy-night	52	0	
4/7/2018 0:00	79	34	45	partly-cloudy-night	51	0	
4/7/2018 1:00	43	26	17	partly-cloudy-night	48	0	
4/7/2018 2:00	20	6	14	partly-cloudy-night	46	0	
4/7/2018 3:00	14	5	9	cloudy	45	0.0033	
4/7/2018 4:00	3	2	1	cloudy	44	0.0059	
4/7/2018 5:00	15	10	5	cloudy	42	0.0084	
4/7/2018 6:00	37	23	14	cloudy	41	0.006	
4/7/2018 7:00	101	45	56	cloudy	40	0.0029	
4/7/2018 8:00	207	79	128	cloudy	40	0.0011	
4/7/2018 9:00	642	344	298	partly-cloudy-day	39	0	
4/7/2018 10:00	985	571	414	partly-cloudy-day	39	0	
4/7/2018 11:00	1681	880	801	partly-cloudy-day	39	0	
4/7/2018 12:00	1900	938	962	partly-cloudy-day	40	0.001	
4/7/2018 13:00	2054	953	1101	partly-cloudy-day	41	0.0007	
4/7/2018 14:00	2422	1048	1374	partly-cloudy-day	43	0	
4/7/2018 15:00	2507	1184	1323	partly-cloudy-day	44	0	
4/7/2018 16:00	2408	1107	1301	partly-cloudy-day	46	0	
4/7/2018 17:00	2092	898	1194	partly-cloudy-day	46	0	
4/7/2018 18:00	1550	631	919	partly-cloudy-day	45	0	
4/7/2018 19:00	968	399	569	partly-cloudy-day	44	0	
4/7/2018 20:00	468	191	277	partly-cloudy-night	43	0	
4/7/2018 21:00	236	112	124	partly-cloudy-night	42	0	
4/7/2018 22:00	132	65	67	partly-cloudy-night	41	0	
4/7/2018 23:00	90	53	37	clear-night	40	0	
4/8/2018 0:00	70	40	30	clear-night	38	0	
4/8/2018 1:00	27	14	13	clear-night	37	0	
4/8/2018 2:00	11	8	3	clear-night	36	0	
4/8/2018 3:00	12	10	2	clear-night	34	0	
4/8/2018 4:00	3	0	3	clear-night	33	0	
4/8/2018 5:00	14	11	3	partly-cloudy-night	32	0.0005	
4/8/2018 6:00	34	18	16	cloudy	32	0.0006	
4/8/2018 7:00	76	42	34	clear-day	32	0	
4/8/2018 8:00	164	91	73	clear-day	32	0	
4/8/2018 9:00	513	355	158	clear-day	34	0	
4/8/2018 10:00	1072	617	455	clear-day	36	0	
4/8/2018 11:00	1609	833	776	clear-day	37	0	
4/8/2018 12:00	1858	829	1029	partly-cloudy-day	41	0	
4/8/2018 13:00	1858	760	1098	partly-cloudy-day	41	0	
4/8/2018 14:00	2083	848	1235	partly-cloudy-day	42	0	
4/8/2018 15:00	1947	822	1125	partly-cloudy-day	43	0	
4/8/2018 16:00	2210	840	1370	partly-cloudy-day	43	0	
4/8/2018 17:00	1580	668	912	partly-cloudy-day	42	0	
4/8/2018 18:00	1204	440	764	partly-cloudy-day	41	0	
4/8/2018 19:00	730	297	433	partly-cloudy-day	40	0	
4/8/2018 20:00	396	220	176	partly-cloudy-night	38	0	
4/8/2018 21:00	202	106	96	clear-night	38	0	
4/8/2018 22:00	63	35	28	clear-night	36	0	
4/8/2018 23:00	30	14	16	clear-night	35	0	
4/9/2018 0:00	2	1	1	clear-night	33	0.0018	
4/9/2018 1:00	2	1	1	clear-night	33	0	
4/9/2018 2:00	6	0	6	clear-night	33	0	
4/9/2018 3:00	4	1	3	clear-night	32	0	
4/9/2018 4:00	4	2	2	clear-night	31	0	
4/9/2018 5:00	21	16	5	clear-night	31	0	
4/9/2018 6:00	82	36	46	clear-night	31	0	
4/9/2018 7:00	143	60	83	clear-day	31	0	
4/9/2018 8:00	272	96	176	clear-day	32	0	
4/9/2018 9:00	367	172	195	clear-day	34	0	
4/9/2018 10:00	674	328	346	partly-cloudy-day	37	0.0014	
4/9/2018 11:00	1035	497	538	partly-cloudy-day	39	0	
4/9/2018 12:00	1342	643	699	partly-cloudy-day	41	0.0005	
4/9/2018 13:00	1453	597	856	clear-day	41	0	
4/9/2018 14:00	1451	710	741	clear-day	47	0.0003	
4/9/2018 15:00	1555	776	779	partly-cloudy-day	45	0	
4/9/2018 16:00	1688	800	888	clear-day	47	0	
4/9/2018 17:00	1239	619	620	partly-cloudy-day	44	0	
4/9/2018 18:00	797	439	358	partly-cloudy-day	42	0	
4/9/2018 19:00	520	263	257	partly-cloudy-day	41	0	
4/9/2018 20:00	325	189	136	partly-cloudy-night	41	0	
4/9/2018 21:00	155	75	80	partly-cloudy-night	41	0	
4/9/2018 22:00	98	43	55	partly-cloudy-night	42	0	
4/9/2018 23:00	51	16	35	partly-cloudy-night	41	0	
4/10/2018 0:00	15	8	7	cloudy	40	0.0019	
4/10/2018 1:00	6	3	3	partly-cloudy-night	40	0	
4/10/2018 2:00	1	0	1	partly-cloudy-night	38	0	
4/10/2018 3:00	0	0	0	partly-cloudy-night	38	0.0007	
4/10/2018 4:00	6	2	4	partly-cloudy-night	37	0.002	
4/10/2018 5:00	18	11	7	partly-cloudy-night	37	0.0011	
4/10/2018 6:00	43	23	20	partly-cloudy-night	37	0.0007	
4/10/2018 7:00	89	40	49	partly-cloudy-day	37	0.0003	
4/10/2018 8:00	182	54	128	partly-cloudy-day	37	0	
4/10/2018 9:00	210	95	115	partly-cloudy-day	38	0	
4/10/2018 10:00	460	300	160	partly-cloudy-day	40	0.0003	
4/10/2018 11:00	828	386	442	partly-cloudy-day	46	0.0015	
4/10/2018 12:00	870	357	513	partly-cloudy-day	47	0.0005	
4/10/2018 13:00	868	391	477	partly-cloudy-day	49	0.0066	
4/10/2018 14:00	1110	470	640	partly-cloudy-day	51	0.0002	
4/10/2018 15:00	1078	502	576	partly-cloudy-day	52	0.0002	
4/10/2018 16:00	1096	571	525	partly-cloudy-day	48	0	
4/10/2018 17:00	1084	594	490	partly-cloudy-day	47	0	
4/10/2018 18:00	867	461	406	partly-cloudy-day	47	0	
4/10/2018 19:00	563	299	264	partly-cloudy-day	46	0	
4/10/2018 20:00	286	144	142	partly-cloudy-night	45	0	
4/10/2018 21:00	196	110	86	clear-night	43	0	
4/10/2018 22:00	92	43	49	clear-night	42	0	
4/10/2018 23:00	21	11	10	clear-night	40	0	
4/11/2018 0:00	13	12	1	clear-night	39	0	
4/11/2018 1:00	11	5	6	clear-night	37	0	
4/11/2018 2:00	4	3	1	clear-night	37	0	
4/11/2018 3:00	2	0	2	clear-night	36	0	
4/11/2018 4:00	5	4	1	clear-night	36	0	
4/11/2018 5:00	30	12	18	clear-night	35	0	
4/11/2018 6:00	97	49	48	clear-night	35	0	
4/11/2018 7:00	181	70	111	clear-day	35	0	
4/11/2018 8:00	288	98	190	clear-day	37	0	
4/11/2018 9:00	458	243	215	clear-day	41	0	
4/11/2018 10:00	1020	529	491	clear-day	43	0	
4/11/2018 11:00	1264	666	598	clear-day	46	0	
4/11/2018 12:00	1378	605	773	clear-day	48	0	
4/11/2018 13:00	1406	664	742	partly-cloudy-day	47	0	
4/11/2018 14:00	1501	664	837	partly-cloudy-day	48	0	
4/11/2018 15:00	1479	678	801	partly-cloudy-day	47	0	
4/11/2018 16:00	1385	654	731	partly-cloudy-day	47	0	
4/11/2018 17:00	1166	552	614	partly-cloudy-day	47	0.0062	
4/11/2018 18:00	971	535	436	partly-cloudy-day	46	0	
4/11/2018 19:00	619	322	297	partly-cloudy-day	46	0	
4/11/2018 20:00	337	128	209	clear-night	45	0	
4/11/2018 21:00	180	79	101	partly-cloudy-night	44	0	
4/11/2018 22:00	167	111	56	partly-cloudy-night	43	0.009	
4/11/2018 23:00	113	91	22	partly-cloudy-night	43	0	
4/12/2018 0:00	19	11	8	partly-cloudy-night	43	0	
4/12/2018 1:00	11	8	3	clear-night	42	0	
4/12/2018 2:00	8	4	4	partly-cloudy-night	42	0	
4/12/2018 3:00	7	5	2	partly-cloudy-night	42	0	
4/12/2018 4:00	6	2	4	partly-cloudy-night	42	0	
4/12/2018 5:00	24	14	10	partly-cloudy-night	43	0	
4/12/2018 6:00	120	51	69	partly-cloudy-night	42	0	
4/12/2018 7:00	230	83	147	partly-cloudy-day	42	0	
4/12/2018 8:00	369	123	246	clear-day	45	0	
4/12/2018 9:00	516	221	295	partly-cloudy-day	47	0	
4/12/2018 10:00	944	590	354	clear-day	50	0.0019	
4/12/2018 11:00	1199	525	674	partly-cloudy-day	52	0	
4/12/2018 12:00	1405	641	764	clear-day	54	0	
4/12/2018 13:00	1583	721	862	clear-day	57	0	
4/12/2018 14:00	1466	661	805	clear-day	58	0.0048	
4/12/2018 15:00	1480	639	841	partly-cloudy-day	55	0	
4/12/2018 16:00	1558	731	827	clear-day	57	0	
4/12/2018 17:00	1355	671	684	clear-day	53	0	
4/12/2018 18:00	1064	576	488	partly-cloudy-day	54	0	
4/12/2018 19:00	765	359	406	clear-day	55	0	
4/12/2018 20:00	646	330	316	clear-night	55	0	
4/12/2018 21:00	339	212	127	clear-night	55	0	
4/12/2018 22:00	268	186	82	clear-night	55	0	
4/12/2018 23:00	192	154	38	clear-night	55	0	
4/13/2018 0:00	107	85	22	clear-night	56	0	
4/13/2018 1:00	19	13	6	clear-night	57	0	
4/13/2018 2:00	22	11	11	clear-night	56	0	
4/13/2018 3:00	5	3	2	clear-night	57	0	
4/13/2018 4:00	5	4	1	clear-night	58	0	
4/13/2018 5:00	29	15	14	clear-night	58	0	
4/13/2018 6:00	100	50	50	clear-night	59	0	
4/13/2018 7:00	236	107	129	clear-day	59	0	
4/13/2018 8:00	372	143	229	partly-cloudy-day	60	0	
4/13/2018 9:00	596	300	296	clear-day	61	0	
4/13/2018 10:00	1083	619	464	clear-day	64	0	
4/13/2018 11:00	1930	901	1029	clear-day	67	0.0006	
4/13/2018 12:00	1966	958	1008	clear-day	72	0	
4/13/2018 13:00	2085	1003	1082	clear-day	75	0	
4/13/2018 14:00	2252	959	1293	clear-day	76	0.0125	
4/13/2018 15:00	2190	1063	1127	clear-day	79	0	
4/13/2018 16:00	2110	1033	1077	clear-day	79	0	
4/13/2018 17:00	2276	1226	1050	clear-day	77	0	
4/13/2018 18:00	1913	1096	817	clear-day	75	0	
4/13/2018 19:00	1823	939	884	clear-day	70	0.0005	
4/13/2018 20:00	873	259	614	clear-night	68	0.0065	
4/13/2018 21:00	543	273	270	clear-night	67	0	
4/13/2018 22:00	387	185	202	clear-night	68	0	
4/13/2018 23:00	326	219	107	clear-night	66	0	
4/14/2018 0:00	176	125	51	clear-night	66	0	
4/14/2018 1:00	64	36	28	clear-night	64	0	
4/14/2018 2:00	25	14	11	clear-night	63	0	
4/14/2018 3:00	30	18	12	clear-night	63	0	
4/14/2018 4:00	9	5	4	clear-night	62	0	
4/14/2018 5:00	19	13	6	clear-night	61	0	
4/14/2018 6:00	176	65	111	clear-night	60	0	
4/14/2018 7:00	250	106	144	clear-day	60	0	
4/14/2018 8:00	386	190	196	clear-day	62	0	
4/14/2018 9:00	980	596	384	clear-day	66	0	
4/14/2018 10:00	1894	1129	765	clear-day	68	0	
4/14/2018 11:00	2822	1736	1086	clear-day	71	0	
4/14/2018 12:00	3050	1498	1552	clear-day	71	0	
4/14/2018 13:00	3263	1581	1682	clear-day	74	0	
4/14/2018 14:00	3435	1643	1792	clear-day	74	0	
4/14/2018 15:00	3756	1848	1908	clear-day	72	0	
4/14/2018 16:00	3469	1532	1937	clear-day	71	0	
4/14/2018 17:00	3587	1472	2115	clear-day	67	0	
4/14/2018 18:00	2964	1064	1900	clear-day	61	0	
4/14/2018 19:00	1410	407	1003	clear-day	54	0	
4/14/2018 20:00	588	268	320	partly-cloudy-night	52	0	
4/14/2018 21:00	395	243	152	wind	50	0	
4/14/2018 22:00	267	158	109	cloudy	49	0.0049	
4/14/2018 23:00	133	73	60	cloudy	47	0	
4/15/2018 0:00	81	72	9	cloudy	46	0	
4/15/2018 1:00	31	21	10	cloudy	44	0	
4/15/2018 2:00	11	9	2	cloudy	44	0	
4/15/2018 3:00	0	0	0	cloudy	43	0	
4/15/2018 4:00	9	0	9	cloudy	42	0	
4/15/2018 5:00	4	2	2	cloudy	41	0	
4/15/2018 6:00	19	11	8	cloudy	42	0	
4/15/2018 7:00	98	44	54	cloudy	41	0	
4/15/2018 8:00	123	74	49	cloudy	41	0	
4/15/2018 9:00	377	237	140	cloudy	41	0	
4/15/2018 10:00	730	348	382	cloudy	41	0	
4/15/2018 11:00	1021	439	582	cloudy	41	0	
4/15/2018 12:00	1010	444	566	wind	41	0	
4/15/2018 13:00	1010	456	554	wind	41	0	
4/15/2018 14:00	1067	508	559	cloudy	41	0	
4/15/2018 15:00	923	370	553	wind	41	0	
4/15/2018 16:00	812	351	461	cloudy	40	0	
4/15/2018 17:00	604	258	346	cloudy	40	0	
4/15/2018 18:00	199	63	136	cloudy	39	0	
4/15/2018 19:00	50	15	35	partly-cloudy-day	38	0.0058	
4/15/2018 20:00	13	8	5	rain	38	0.0363	
4/15/2018 21:00	18	12	6	rain	38	0.0488	
4/15/2018 22:00	6	4	2	partly-cloudy-night	38	0.0242	
4/15/2018 23:00	5	4	1	rain	38	0.04	
4/16/2018 0:00	3	2	1	partly-cloudy-night	38	0.0232	
4/16/2018 1:00	0	0	0	wind	38	0.0225	
4/16/2018 2:00	0	0	0	rain	39	0.0425	
4/16/2018 3:00	1	0	1	rain	40	0.069	
4/16/2018 4:00	0	0	0	rain	40	0.2847	
4/16/2018 5:00	0	0	0	rain	41	0.1074	
4/16/2018 6:00	10	7	3	rain	41	0.3067	
4/16/2018 7:00	11	4	7	rain	42	0.1009	
4/16/2018 8:00	16	6	10	rain	44	0.1413	
4/16/2018 9:00	14	5	9	rain	46	0.3192	
4/16/2018 10:00	46	27	19	rain	47	0.3613	
4/16/2018 11:00	88	55	33	rain	52	0.2784	
4/16/2018 12:00	166	99	67	rain	55	0.0942	
4/16/2018 13:00	370	222	148	rain	55	0.0306	
4/16/2018 14:00	644	338	306	rain	54	0.2307	
4/16/2018 15:00	996	472	524	partly-cloudy-day	55	0.0025	
4/16/2018 16:00	1244	694	550	clear-day	56	0.0032	
4/16/2018 17:00	1372	719	653	clear-day	55	0.0013	
4/16/2018 18:00	1007	446	561	partly-cloudy-day	55	0.0013	
4/16/2018 19:00	558	264	294	partly-cloudy-day	52	0.0016	
4/16/2018 20:00	280	122	158	partly-cloudy-night	50	0.0017	
4/16/2018 21:00	144	64	80	partly-cloudy-night	49	0.0033	
4/16/2018 22:00	119	48	71	partly-cloudy-night	47	0.0012	
4/16/2018 23:00	59	28	31	partly-cloudy-night	46	0.0016	
4/17/2018 0:00	39	19	20	partly-cloudy-night	45	0.002	Tax Day
4/17/2018 1:00	13	7	6	partly-cloudy-night	44	0.0012	Tax Day
4/17/2018 2:00	2	1	1	partly-cloudy-night	45	0.0012	Tax Day
4/17/2018 3:00	2	0	2	partly-cloudy-night	44	0.0012	Tax Day
4/17/2018 4:00	2	0	2	partly-cloudy-night	43	0.0007	Tax Day
4/17/2018 5:00	32	14	18	partly-cloudy-night	41	0.0016	Tax Day
4/17/2018 6:00	78	43	35	partly-cloudy-night	41	0.0009	Tax Day
4/17/2018 7:00	178	70	108	partly-cloudy-day	41	0.0009	Tax Day
4/17/2018 8:00	308	118	190	partly-cloudy-day	41	0.0035	Tax Day
4/17/2018 9:00	444	248	196	partly-cloudy-day	42	0.0004	Tax Day
4/17/2018 10:00	859	491	368	partly-cloudy-day	44	0.0004	Tax Day
4/17/2018 11:00	1384	679	705	partly-cloudy-day	44	0.0008	Tax Day
4/17/2018 12:00	1480	650	830	partly-cloudy-day	45	0.0004	Tax Day
4/17/2018 13:00	1410	640	770	partly-cloudy-day	45	0.0004	Tax Day
4/17/2018 14:00	1390	536	854	partly-cloudy-day	45	0.0057	Tax Day
4/17/2018 15:00	1297	628	669	partly-cloudy-day	45	0.0058	Tax Day
4/17/2018 16:00	1452	653	799	partly-cloudy-day	44	0.0004	Tax Day
4/17/2018 17:00	979	518	461	partly-cloudy-day	43	0.0004	Tax Day
4/17/2018 18:00	795	427	368	partly-cloudy-day	43	0.0007	Tax Day
4/17/2018 19:00	372	217	155	partly-cloudy-day	41	0.0008	Tax Day
4/17/2018 20:00	290	157	133	partly-cloudy-night	41	0.0004	Tax Day
4/17/2018 21:00	185	93	92	partly-cloudy-night	41	0.0004	Tax Day
4/17/2018 22:00	73	31	42	partly-cloudy-night	40	0.0003	Tax Day
4/17/2018 23:00	50	31	19	partly-cloudy-night	40	0.0003	Tax Day
4/18/2018 0:00	26	9	17	partly-cloudy-night	39	0.0003	
4/18/2018 1:00	6	1	5	clear-night	39	0.0003	
4/18/2018 2:00	6	4	2	partly-cloudy-night	38	0.0003	
4/18/2018 3:00	1	0	1	partly-cloudy-night	37	0.0003	
4/18/2018 4:00	9	5	4	partly-cloudy-night	37	0	
4/18/2018 5:00	19	11	8	cloudy	37	0.0003	
4/18/2018 6:00	103	52	51	cloudy	38	0.0003	
4/18/2018 7:00	184	69	115	cloudy	38	0	
4/18/2018 8:00	379	194	185	cloudy	39	0	
4/18/2018 9:00	527	249	278	partly-cloudy-day	40	0.0003	
4/18/2018 10:00	1060	561	499	partly-cloudy-day	43	0.0003	
4/18/2018 11:00	1488	755	733	partly-cloudy-day	44	0	
4/18/2018 12:00	1775	776	999	partly-cloudy-day	46	0.0004	
4/18/2018 13:00	1781	823	958	partly-cloudy-day	47	0.0003	
4/18/2018 14:00	1940	872	1068	partly-cloudy-day	49	0	
4/18/2018 15:00	2049	1025	1024	clear-day	50	0	
4/18/2018 16:00	1886	875	1011	clear-day	51	0	
4/18/2018 17:00	1898	952	946	clear-day	52	0	
4/18/2018 18:00	1487	810	677	clear-day	52	0	
4/18/2018 19:00	1216	514	702	clear-day	51	0	
4/18/2018 20:00	518	185	333	clear-night	50	0	
4/18/2018 21:00	299	130	169	clear-night	48	0	
4/18/2018 22:00	126	59	67	clear-night	46	0	
4/18/2018 23:00	74	29	45	partly-cloudy-night	47	0	
4/19/2018 0:00	53	26	27	cloudy	47	0	
4/19/2018 1:00	9	7	2	cloudy	47	0	
4/19/2018 2:00	3	0	3	cloudy	46	0.0004	
4/19/2018 3:00	0	0	0	partly-cloudy-night	44	0.0056	
4/19/2018 4:00	1	0	1	partly-cloudy-night	44	0.0101	
4/19/2018 5:00	6	3	3	cloudy	43	0.0123	
4/19/2018 6:00	53	29	24	rain	43	0.0376	
4/19/2018 7:00	105	41	64	rain	42	0.0304	
4/19/2018 8:00	188	81	107	partly-cloudy-day	42	0.0061	
4/19/2018 9:00	284	124	160	partly-cloudy-day	43	0.0011	
4/19/2018 10:00	461	259	202	partly-cloudy-day	43	0.0007	
4/19/2018 11:00	956	396	560	partly-cloudy-day	43	0	
4/19/2018 12:00	699	331	368	partly-cloudy-day	43	0.0024	
4/19/2018 13:00	796	322	474	partly-cloudy-day	43	0.0014	
4/19/2018 14:00	391	145	246	partly-cloudy-day	43	0.008	
4/19/2018 15:00	354	210	144	partly-cloudy-day	42	0.0216	
4/19/2018 16:00	669	363	306	partly-cloudy-day	44	0.0093	
4/19/2018 17:00	802	419	383	partly-cloudy-day	45	0.0031	
4/19/2018 18:00	743	456	287	rain	45	0.192	
4/19/2018 19:00	644	303	341	partly-cloudy-day	44	0.0005	
4/19/2018 20:00	291	146	145	partly-cloudy-night	43	0	
4/19/2018 21:00	139	92	47	clear-night	42	0	
4/19/2018 22:00	132	99	33	clear-night	40	0	
4/19/2018 23:00	91	78	13	clear-night	39	0	
4/20/2018 0:00	18	7	11	clear-night	38	0	
4/20/2018 1:00	8	6	2	clear-night	37	0	
4/20/2018 2:00	4	1	3	clear-night	37	0	
4/20/2018 3:00	6	3	3	clear-night	37	0	
4/20/2018 4:00	3	1	2	partly-cloudy-night	37	0	
4/20/2018 5:00	43	36	7	partly-cloudy-night	36	0	
4/20/2018 6:00	118	46	72	partly-cloudy-night	36	0	
4/20/2018 7:00	194	101	93	clear-day	36	0	
4/20/2018 8:00	294	120	174	clear-day	38	0	
4/20/2018 9:00	766	378	388	clear-day	40	0	
4/20/2018 10:00	1358	835	523	clear-day	41	0	
4/20/2018 11:00	1776	848	928	clear-day	43	0	
4/20/2018 12:00	2156	866	1290	clear-day	45	0.0094	
4/20/2018 13:00	2006	911	1095	clear-day	48	0	
4/20/2018 14:00	2310	1045	1265	clear-day	49	0	
4/20/2018 15:00	2315	1156	1159	clear-day	49	0	
4/20/2018 16:00	2327	1046	1281	clear-day	49	0	
4/20/2018 17:00	2072	984	1088	clear-day	49	0	
4/20/2018 18:00	1642	794	848	clear-day	47	0	
4/20/2018 19:00	935	437	498	clear-day	46	0	
4/20/2018 20:00	559	200	359	clear-night	44	0	
4/20/2018 21:00	414	183	231	clear-night	43	0	
4/20/2018 22:00	182	73	109	clear-night	42	0	
4/20/2018 23:00	141	112	29	clear-night	41	0	
4/21/2018 0:00	168	154	14	clear-night	40	0	
4/21/2018 1:00	96	88	8	clear-night	40	0	
4/21/2018 2:00	9	3	6	clear-night	39	0	
4/21/2018 3:00	3	2	1	clear-night	38	0	
4/21/2018 4:00	6	0	6	clear-night	38	0	
4/21/2018 5:00	11	8	3	clear-night	38	0	
4/21/2018 6:00	52	29	23	clear-night	38	0	
4/21/2018 7:00	142	84	58	clear-day	39	0	
4/21/2018 8:00	308	172	136	clear-day	41	0	
4/21/2018 9:00	672	410	262	clear-day	45	0	
4/21/2018 10:00	1805	1128	677	clear-day	49	0	
4/21/2018 11:00	2302	1330	972	clear-day	52	0.001	
4/21/2018 12:00	2924	1435	1489	clear-day	53	0	
4/21/2018 13:00	3106	1511	1595	clear-day	55	0	
4/21/2018 14:00	3209	1494	1715	clear-day	57	0	
4/21/2018 15:00	3278	1532	1746	clear-day	58	0	
4/21/2018 16:00	3321	1484	1837	clear-day	60	0	
4/21/2018 17:00	3028	1207	1821	clear-day	60	0	
4/21/2018 18:00	2410	980	1430	clear-day	59	0	
4/21/2018 19:00	1733	756	977	clear-day	58	0	
4/21/2018 20:00	1005	369	636	clear-night	56	0	
4/21/2018 21:00	529	253	276	clear-night	55	0	
4/21/2018 22:00	282	136	146	clear-night	54	0	
4/21/2018 23:00	193	114	79	clear-night	52	0	
4/22/2018 0:00	148	115	33	clear-night	51	0	
4/22/2018 1:00	31	15	16	clear-night	50	0	
4/22/2018 2:00	28	17	11	clear-night	48	0	
4/22/2018 3:00	24	15	9	clear-night	46	0	
4/22/2018 4:00	6	4	2	clear-night	45	0	
4/22/2018 5:00	17	10	7	clear-night	44	0	
4/22/2018 6:00	82	40	42	clear-night	43	0	
4/22/2018 7:00	167	76	91	clear-day	42	0	
4/22/2018 8:00	321	173	148	clear-day	46	0	
4/22/2018 9:00	895	589	306	clear-day	52	0	
4/22/2018 10:00	1755	963	792	clear-day	54	0	
4/22/2018 11:00	1984	1119	865	clear-day	57	0.0014	
4/22/2018 12:00	2463	1343	1120	clear-day	60	0	
4/22/2018 13:00	2910	1396	1514	clear-day	60	0	
4/22/2018 14:00	2887	1271	1616	clear-day	62	0	
4/22/2018 15:00	2878	1299	1579	clear-day	63	0	
4/22/2018 16:00	2689	1119	1570	clear-day	62	0.0043	
4/22/2018 17:00	2353	970	1383	clear-day	61	0	
4/22/2018 18:00	1919	819	1100	clear-day	59	0	
4/22/2018 19:00	1481	509	972	clear-day	56	0	
4/22/2018 20:00	712	267	445	clear-night	53	0	
4/22/2018 21:00	398	189	209	clear-night	52	0	
4/22/2018 22:00	174	95	79	clear-night	50	0	
4/22/2018 23:00	59	26	33	clear-night	49	0	
4/23/2018 0:00	30	21	9	clear-night	49	0	
4/23/2018 1:00	5	4	1	clear-night	47	0	
4/23/2018 2:00	3	1	2	clear-night	45	0	
4/23/2018 3:00	4	1	3	clear-night	44	0	
4/23/2018 4:00	3	1	2	clear-night	43	0	
4/23/2018 5:00	27	16	11	clear-night	43	0	
4/23/2018 6:00	110	60	50	clear-night	42	0	
4/23/2018 7:00	226	98	128	clear-day	45	0	
4/23/2018 8:00	425	147	278	clear-day	50	0	
4/23/2018 9:00	653	342	311	clear-day	52	0	
4/23/2018 10:00	1249	810	439	clear-day	55	0	
4/23/2018 11:00	1746	863	883	clear-day	58	0	
4/23/2018 12:00	1797	845	952	clear-day	60	0	
4/23/2018 13:00	1937	929	1008	clear-day	61	0	
4/23/2018 14:00	2039	959	1080	clear-day	61	0	
4/23/2018 15:00	2123	1019	1104	clear-day	60	0	
4/23/2018 16:00	1975	963	1012	clear-day	60	0	
4/23/2018 17:00	2071	1021	1050	clear-day	58	0	
4/23/2018 18:00	1540	862	678	clear-day	56	0.0012	
4/23/2018 19:00	1052	497	555	clear-day	54	0	
4/23/2018 20:00	617	249	368	clear-night	51	0	
4/23/2018 21:00	311	139	172	clear-night	50	0	
4/23/2018 22:00	151	49	102	clear-night	49	0	
4/23/2018 23:00	60	27	33	clear-night	48	0	
4/24/2018 0:00	30	14	16	clear-night	48	0	
4/24/2018 1:00	6	4	2	clear-night	47	0	
4/24/2018 2:00	4	1	3	clear-night	47	0	
4/24/2018 3:00	11	4	7	clear-night	46	0	
4/24/2018 4:00	10	6	4	clear-night	45	0	
4/24/2018 5:00	37	23	14	clear-night	44	0	
4/24/2018 6:00	119	65	54	clear-night	44	0	
4/24/2018 7:00	232	93	139	clear-day	45	0	
4/24/2018 8:00	424	154	270	clear-day	50	0.0046	
4/24/2018 9:00	711	387	324	clear-day	53	0	
4/24/2018 10:00	1361	777	584	clear-day	56	0	
4/24/2018 11:00	1775	866	909	clear-day	59	0	
4/24/2018 12:00	1805	772	1033	partly-cloudy-day	61	0	
4/24/2018 13:00	1767	811	956	clear-day	61	0	
4/24/2018 14:00	1840	829	1011	clear-day	62	0	
4/24/2018 15:00	1778	755	1023	clear-day	61	0.0008	
4/24/2018 16:00	1690	742	948	clear-day	59	0	
4/24/2018 17:00	1529	732	797	clear-day	58	0	
4/24/2018 18:00	1236	646	590	partly-cloudy-day	57	0	
4/24/2018 19:00	738	344	394	partly-cloudy-day	56	0	
4/24/2018 20:00	474	204	270	partly-cloudy-night	55	0	
4/24/2018 21:00	219	86	133	partly-cloudy-night	54	0	
4/24/2018 22:00	39	27	12	partly-cloudy-night	54	0	
4/24/2018 23:00	36	30	6	partly-cloudy-night	53	0.0026	
4/25/2018 0:00	13	10	3	partly-cloudy-night	53	0.0148	
4/25/2018 1:00	6	4	2	partly-cloudy-night	52	0.0161	
4/25/2018 2:00	3	2	1	partly-cloudy-night	52	0.0128	
4/25/2018 3:00	3	2	1	partly-cloudy-night	52	0.0084	
4/25/2018 4:00	1	0	1	partly-cloudy-night	52	0.0207	
4/25/2018 5:00	7	4	3	cloudy	53	0.0123	
4/25/2018 6:00	17	11	6	cloudy	54	0.0225	
4/25/2018 7:00	34	10	24	rain	54	0.0647	
4/25/2018 8:00	52	14	38	rain	54	0.0811	
4/25/2018 9:00	97	44	53	rain	55	0.0452	
4/25/2018 10:00	252	128	124	rain	55	0.0364	
4/25/2018 11:00	336	162	174	rain	55	0.034	
4/25/2018 12:00	349	168	181	rain	56	0.0387	
4/25/2018 13:00	462	230	232	rain	57	0.0511	
4/25/2018 14:00	445	220	225	rain	57	0.033	
4/25/2018 15:00	376	197	179	fog	57	0.0223	
4/25/2018 16:00	449	244	205	cloudy	56	0.0122	
4/25/2018 17:00	719	419	300	cloudy	56	0.0024	
4/25/2018 18:00	501	289	212	cloudy	56	0.0008	
4/25/2018 19:00	432	251	181	cloudy	55	0.0004	
4/25/2018 20:00	173	97	76	fog	54	0.0047	
4/25/2018 21:00	101	56	45	fog	54	0.0018	
4/25/2018 22:00	75	51	24	fog	54	0.0004	
4/25/2018 23:00	58	32	26	cloudy	53	0.0012	
4/26/2018 0:00	12	7	5	partly-cloudy-night	54	0.0068	
4/26/2018 1:00	0	0	0	rain	53	0.0491	
4/26/2018 2:00	3	2	1	rain	53	0.0335	
4/26/2018 3:00	1	0	1	partly-cloudy-night	54	0.0016	
4/26/2018 4:00	4	2	2	partly-cloudy-night	55	0.0027	
4/26/2018 5:00	32	20	12	partly-cloudy-night	56	0	
4/26/2018 6:00	172	85	87	partly-cloudy-night	55	0.0002	
4/26/2018 7:00	261	103	158	partly-cloudy-day	55	0	
4/26/2018 8:00	510	171	339	partly-cloudy-day	56	0	
4/26/2018 9:00	797	425	372	clear-day	56	0.0002	
4/26/2018 10:00	1606	939	667	clear-day	57	0.0027	
4/26/2018 11:00	2035	995	1040	clear-day	59	0	
4/26/2018 12:00	2187	1009	1178	clear-day	60	0.0011	
4/26/2018 13:00	2290	990	1300	clear-day	62	0	
4/26/2018 14:00	2261	1041	1220	clear-day	65	0	
4/26/2018 15:00	2663	1207	1456	clear-day	66	0	
4/26/2018 16:00	2537	1213	1324	clear-day	67	0.0004	
4/26/2018 17:00	2501	1245	1256	clear-day	67	0	
4/26/2018 18:00	1996	1046	950	clear-day	67	0	
4/26/2018 19:00	1613	817	796	clear-day	65	0	
4/26/2018 20:00	860	327	533	clear-night	63	0	
4/26/2018 21:00	511	230	281	clear-night	62	0	
4/26/2018 22:00	363	179	184	clear-night	59	0	
4/26/2018 23:00	213	120	93	clear-night	58	0	
4/27/2018 0:00	62	30	32	clear-night	57	0	
4/27/2018 1:00	30	16	14	clear-night	56	0	
4/27/2018 2:00	6	0	6	clear-night	55	0	
4/27/2018 3:00	14	7	7	clear-night	55	0	
4/27/2018 4:00	12	8	4	clear-night	55	0	
4/27/2018 5:00	30	16	14	clear-night	54	0	
4/27/2018 6:00	138	65	73	cloudy	53	0	
4/27/2018 7:00	189	75	114	clear-day	54	0	
4/27/2018 8:00	227	87	140	partly-cloudy-day	54	0	
4/27/2018 9:00	239	132	107	partly-cloudy-day	53	0.0124	
4/27/2018 10:00	629	396	233	partly-cloudy-day	53	0.0054	
4/27/2018 11:00	719	297	422	partly-cloudy-day	53	0.0073	
4/27/2018 12:00	650	370	280	rain	55	0.054	
4/27/2018 13:00	1028	536	492	partly-cloudy-day	53	0.0045	
4/27/2018 14:00	1253	595	658	partly-cloudy-day	53	0.0002	
4/27/2018 15:00	1181	503	678	partly-cloudy-day	52	0.0011	
4/27/2018 16:00	950	520	430	cloudy	52	0.0006	
4/27/2018 17:00	1018	538	480	cloudy	51	0.0017	
4/27/2018 18:00	708	405	303	cloudy	54	0.0032	
4/27/2018 19:00	565	300	265	partly-cloudy-day	51	0.0007	
4/27/2018 20:00	321	159	162	partly-cloudy-night	51	0.0008	
4/27/2018 21:00	260	151	109	partly-cloudy-night	52	0	
4/27/2018 22:00	263	139	124	partly-cloudy-night	52	0	
4/27/2018 23:00	80	38	42	partly-cloudy-night	52	0	
4/28/2018 0:00	61	43	18	partly-cloudy-night	52	0	
4/28/2018 1:00	21	14	7	partly-cloudy-night	50	0.0017	
4/28/2018 2:00	11	3	8	partly-cloudy-night	50	0	
4/28/2018 3:00	1	1	0	partly-cloudy-night	50	0	
4/28/2018 4:00	7	4	3	partly-cloudy-night	50	0	
4/28/2018 5:00	23	19	4	partly-cloudy-night	49	0	
4/28/2018 6:00	74	33	41	partly-cloudy-night	48	0	
4/28/2018 7:00	198	100	98	partly-cloudy-day	48	0.0005	
4/28/2018 8:00	433	228	205	partly-cloudy-day	50	0.0003	
4/28/2018 9:00	943	541	402	partly-cloudy-day	51	0	
4/28/2018 10:00	2157	1336	821	partly-cloudy-day	53	0	
4/28/2018 11:00	2928	1489	1439	partly-cloudy-day	57	0	
4/28/2018 12:00	3325	1783	1542	partly-cloudy-day	60	0	
4/28/2018 13:00	3539	1703	1836	partly-cloudy-day	62	0.0014	
4/28/2018 14:00	3831	1846	1985	clear-day	64	0	
4/28/2018 15:00	3812	1826	1986	clear-day	64	0	
4/28/2018 16:00	3638	1484	2154	clear-day	63	0	
4/28/2018 17:00	3350	1313	2037	clear-day	62	0.0012	
4/28/2018 18:00	2670	1042	1628	clear-day	61	0.0006	
4/28/2018 19:00	1972	703	1269	clear-day	58	0	
4/28/2018 20:00	603	225	378	rain	56	0.0383	
4/28/2018 21:00	169	108	61	rain	55	0.0665	
4/28/2018 22:00	82	65	17	rain	54	0.04	
4/28/2018 23:00	46	40	6	rain	55	0.0563	
4/29/2018 0:00	21	13	8	cloudy	53	0.0069	
4/29/2018 1:00	24	16	8	partly-cloudy-night	53	0.0116	
4/29/2018 2:00	13	9	4	cloudy	53	0.0069	
4/29/2018 3:00	6	5	1	partly-cloudy-night	52	0.0142	
4/29/2018 4:00	7	5	2	rain	52	0.2161	
4/29/2018 5:00	10	8	2	cloudy	53	0.0184	
4/29/2018 6:00	37	14	23	partly-cloudy-night	51	0.0011	
4/29/2018 7:00	78	46	32	partly-cloudy-day	49	0.0045	
4/29/2018 8:00	248	148	100	partly-cloudy-day	49	0.0013	
4/29/2018 9:00	656	442	214	partly-cloudy-day	49	0.0003	
4/29/2018 10:00	1524	879	645	partly-cloudy-day	50	0.0006	
4/29/2018 11:00	2013	1134	879	partly-cloudy-day	54	0.0022	
4/29/2018 12:00	2414	1150	1264	partly-cloudy-day	55	0.001	
4/29/2018 13:00	3149	1462	1687	partly-cloudy-day	55	0	
4/29/2018 14:00	2788	1165	1623	partly-cloudy-day	55	0	
4/29/2018 15:00	2982	1237	1745	partly-cloudy-day	55	0	
4/29/2018 16:00	2829	1091	1738	partly-cloudy-day	55	0	
4/29/2018 17:00	2636	1029	1607	partly-cloudy-day	54	0	
4/29/2018 18:00	1835	615	1220	partly-cloudy-day	52	0	
4/29/2018 19:00	1099	457	642	partly-cloudy-day	51	0	
4/29/2018 20:00	693	265	428	partly-cloudy-night	49	0	
4/29/2018 21:00	321	128	193	partly-cloudy-night	47	0	
4/29/2018 22:00	137	46	91	clear-night	47	0	
4/29/2018 23:00	68	26	42	partly-cloudy-night	47	0	
4/30/2018 0:00	34	14	20	partly-cloudy-night	47	0	
4/30/2018 1:00	12	3	9	partly-cloudy-night	47	0	
4/30/2018 2:00	8	5	3	partly-cloudy-night	47	0	
4/30/2018 3:00	3	0	3	partly-cloudy-night	46	0	
4/30/2018 4:00	2	0	2	clear-night	46	0	
4/30/2018 5:00	43	21	22	partly-cloudy-night	46	0	
4/30/2018 6:00	92	42	50	partly-cloudy-night	46	0	
4/30/2018 7:00	163	70	93	partly-cloudy-day	46	0	
4/30/2018 8:00	384	168	216	partly-cloudy-day	47	0	
4/30/2018 9:00	577	279	298	partly-cloudy-day	49	0	
4/30/2018 10:00	1093	627	466	partly-cloudy-day	48	0	
4/30/2018 11:00	1183	536	647	partly-cloudy-day	47	0.0004	
4/30/2018 12:00	1239	562	677	partly-cloudy-day	45	0.0022	
4/30/2018 13:00	1301	590	711	partly-cloudy-day	47	0.0003	
4/30/2018 14:00	1333	564	769	partly-cloudy-day	50	0	
4/30/2018 15:00	870	395	475	partly-cloudy-day	49	0.0028	
4/30/2018 16:00	842	392	450	partly-cloudy-day	48	0.0032	
4/30/2018 17:00	664	288	376	partly-cloudy-day	49	0.0019	
4/30/2018 18:00	513	336	177	partly-cloudy-day	48	0.006	
4/30/2018 19:00	308	182	126	partly-cloudy-day	48	0.006	
4/30/2018 20:00	181	94	87	partly-cloudy-night	48	0.0028	
4/30/2018 21:00	188	96	92	partly-cloudy-night	48	0.0004	
4/30/2018 22:00	125	43	82	partly-cloudy-night	48	0.0003	
4/30/2018 23:00	48	19	29	partly-cloudy-night	49	0.0004	
5/1/2018 0:00	52	17	35	partly-cloudy-night	47	0	
5/1/2018 1:00	8	4	4	partly-cloudy-night	48	0	
5/1/2018 2:00	2	1	1	partly-cloudy-night	47	0	
5/1/2018 3:00	1	0	1	partly-cloudy-night	47	0	
5/1/2018 4:00	5	3	2	partly-cloudy-night	47	0	
5/1/2018 5:00	57	33	24	partly-cloudy-night	47	0	
5/1/2018 6:00	177	81	96	partly-cloudy-night	46	0	
5/1/2018 7:00	258	115	143	clear-day	46	0	
5/1/2018 8:00	609	220	389	clear-day	52	0	
5/1/2018 9:00	886	489	397	clear-day	56	0	
5/1/2018 10:00	1626	979	647	clear-day	61	0.0027	
5/1/2018 11:00	2180	1028	1152	clear-day	66	0	
5/1/2018 12:00	2517	1116	1401	clear-day	71	0.0003	
5/1/2018 13:00	2307	966	1341	clear-day	72	0.0011	
5/1/2018 14:00	2442	1032	1410	clear-day	74	0	
5/1/2018 15:00	2384	1008	1376	clear-day	76	0.0024	
5/1/2018 16:00	2237	1021	1216	clear-day	78	0	
5/1/2018 17:00	2144	1109	1035	clear-day	78	0.001	
5/1/2018 18:00	2035	1178	857	clear-day	78	0.0013	
5/1/2018 19:00	1579	865	714	clear-day	76	0.0014	
5/1/2018 20:00	1066	424	642	clear-night	74	0	
5/1/2018 21:00	570	185	385	clear-night	71	0.0048	
5/1/2018 22:00	289	114	175	clear-night	70	0	
5/1/2018 23:00	185	111	74	clear-night	68	0	
5/2/2018 0:00	63	37	26	clear-night	65	0	
5/2/2018 1:00	39	19	20	clear-night	66	0	
5/2/2018 2:00	26	8	18	clear-night	65	0	
5/2/2018 3:00	2	0	2	clear-night	63	0	
5/2/2018 4:00	7	3	4	clear-night	62	0	
5/2/2018 5:00	65	43	22	clear-night	61	0	
5/2/2018 6:00	255	113	142	clear-day	60	0	
5/2/2018 7:00	359	163	196	clear-day	59	0.0015	
5/2/2018 8:00	606	189	417	clear-day	64	0.0019	
5/2/2018 9:00	759	372	387	clear-day	71	0	
5/2/2018 10:00	1379	831	548	clear-day	76	0	
5/2/2018 11:00	1747	875	872	clear-day	80	0	
5/2/2018 12:00	2022	942	1080	partly-cloudy-day	83	0	
5/2/2018 13:00	1861	888	973	clear-day	86	0	
5/2/2018 14:00	1787	832	955	clear-day	88	0.0006	
5/2/2018 15:00	1884	879	1005	clear-day	89	0	
5/2/2018 16:00	1860	899	961	partly-cloudy-day	90	0.0002	
5/2/2018 17:00	1890	1006	884	partly-cloudy-day	86	0.0011	
5/2/2018 18:00	1907	1188	719	clear-day	85	0	
5/2/2018 19:00	1550	805	745	partly-cloudy-day	84	0.0012	
5/2/2018 20:00	1025	425	600	partly-cloudy-night	83	0.0004	
5/2/2018 21:00	596	259	337	partly-cloudy-night	80	0.0009	
5/2/2018 22:00	304	138	166	partly-cloudy-night	78	0	
5/2/2018 23:00	189	110	79	partly-cloudy-night	76	0	
5/3/2018 0:00	47	22	25	clear-night	75	0	
5/3/2018 1:00	20	16	4	clear-night	73	0	
5/3/2018 2:00	19	9	10	clear-night	71	0	
5/3/2018 3:00	12	8	4	clear-night	69	0	
5/3/2018 4:00	7	2	5	clear-night	69	0	
5/3/2018 5:00	59	35	24	clear-night	67	0	
5/3/2018 6:00	200	88	112	clear-day	67	0	
5/3/2018 7:00	335	122	213	clear-day	67	0	
5/3/2018 8:00	506	180	326	clear-day	71	0	
5/3/2018 9:00	738	323	415	clear-day	75	0	
5/3/2018 10:00	1453	880	573	clear-day	79	0	
5/3/2018 11:00	1747	903	844	clear-day	83	0	
5/3/2018 12:00	1565	771	794	clear-day	85	0	
5/3/2018 13:00	1713	803	910	clear-day	86	0	
5/3/2018 14:00	1758	706	1052	partly-cloudy-day	88	0	
5/3/2018 15:00	1722	765	957	clear-day	89	0	
5/3/2018 16:00	1484	718	766	clear-day	89	0	
5/3/2018 17:00	1814	1017	797	clear-day	89	0	
5/3/2018 18:00	1676	967	709	clear-day	88	0	
5/3/2018 19:00	1326	543	783	clear-day	85	0.0027	
5/3/2018 20:00	687	273	414	rain	74	0.038	
5/3/2018 21:00	544	246	298	partly-cloudy-night	72	0.0045	
5/3/2018 22:00	355	177	178	partly-cloudy-night	71	0.0004	
5/3/2018 23:00	166	78	88	partly-cloudy-night	71	0.0054	
5/4/2018 0:00	66	43	23	partly-cloudy-night	70	0.0039	
5/4/2018 1:00	34	10	24	partly-cloudy-night	69	0	
5/4/2018 2:00	21	13	8	clear-night	68	0	
5/4/2018 3:00	6	2	4	partly-cloudy-night	68	0.0003	
5/4/2018 4:00	8	6	2	clear-night	68	0	
5/4/2018 5:00	37	24	13	partly-cloudy-night	68	0	
5/4/2018 6:00	192	95	97	clear-day	68	0	
5/4/2018 7:00	279	156	123	clear-day	68	0	
5/4/2018 8:00	516	219	297	partly-cloudy-day	72	0.0014	
5/4/2018 9:00	857	512	345	partly-cloudy-day	72	0	
5/4/2018 10:00	1536	787	749	partly-cloudy-day	72	0.0035	
5/4/2018 11:00	1835	932	903	partly-cloudy-day	73	0.0025	
5/4/2018 12:00	2223	1008	1215	partly-cloudy-day	74	0.0006	
5/4/2018 13:00	2003	917	1086	partly-cloudy-day	75	0.0003	
5/4/2018 14:00	1967	921	1046	clear-day	78	0	
5/4/2018 15:00	2125	1108	1017	clear-day	80	0	
5/4/2018 16:00	2050	893	1157	clear-day	79	0	
5/4/2018 17:00	2111	1103	1008	clear-day	80	0	
5/4/2018 18:00	1600	883	717	clear-day	78	0	
5/4/2018 19:00	1264	680	584	clear-day	80	0	
5/4/2018 20:00	938	394	544	partly-cloudy-night	80	0	
5/4/2018 21:00	673	289	384	partly-cloudy-night	76	0	
5/4/2018 22:00	364	141	223	clear-night	79	0	
5/4/2018 23:00	308	181	127	clear-night	79	0	
5/5/2018 0:00	185	102	83	clear-night	75	0	Cinco de Mayo
5/5/2018 1:00	62	24	38	partly-cloudy-night	74	0	Cinco de Mayo
5/5/2018 2:00	32	9	23	partly-cloudy-night	71	0	Cinco de Mayo
5/5/2018 3:00	24	16	8	partly-cloudy-night	69	0	Cinco de Mayo
5/5/2018 4:00	18	11	7	clear-night	67	0	Cinco de Mayo
5/5/2018 5:00	39	28	11	clear-night	64	0	Cinco de Mayo
5/5/2018 6:00	113	57	56	clear-day	62	0	Cinco de Mayo
5/5/2018 7:00	219	111	108	clear-day	61	0	Cinco de Mayo
5/5/2018 8:00	475	235	240	clear-day	61	0	Cinco de Mayo
5/5/2018 9:00	852	544	308	clear-day	61	0	Cinco de Mayo
5/5/2018 10:00	1759	1016	743	clear-day	63	0	Cinco de Mayo
5/5/2018 11:00	2454	1353	1101	clear-day	65	0	Cinco de Mayo
5/5/2018 12:00	2854	1574	1280	clear-day	68	0	Cinco de Mayo
5/5/2018 13:00	2874	1456	1418	clear-day	70	0	Cinco de Mayo
5/5/2018 14:00	3235	1430	1805	clear-day	71	0	Cinco de Mayo
5/5/2018 15:00	3390	1490	1900	clear-day	71	0	Cinco de Mayo
5/5/2018 16:00	3255	1292	1963	clear-day	71	0	Cinco de Mayo
5/5/2018 17:00	2956	1239	1717	clear-day	70	0	Cinco de Mayo
5/5/2018 18:00	2405	934	1471	partly-cloudy-day	69	0	Cinco de Mayo
5/5/2018 19:00	1606	575	1031	clear-day	66	0	Cinco de Mayo
5/5/2018 20:00	1006	401	605	clear-night	65	0	Cinco de Mayo
5/5/2018 21:00	708	265	443	clear-night	65	0	Cinco de Mayo
5/5/2018 22:00	342	168	174	partly-cloudy-night	64	0	Cinco de Mayo
5/5/2018 23:00	218	123	95	partly-cloudy-night	64	0	Cinco de Mayo
5/6/2018 0:00	149	86	63	partly-cloudy-night	63	0	
5/6/2018 1:00	76	24	52	partly-cloudy-night	63	0	
5/6/2018 2:00	30	18	12	partly-cloudy-night	61	0	
5/6/2018 3:00	14	6	8	partly-cloudy-night	60	0	
5/6/2018 4:00	7	5	2	partly-cloudy-night	60	0	
5/6/2018 5:00	19	11	8	cloudy	60	0.0007	
5/6/2018 6:00	132	52	80	partly-cloudy-day	59	0.0016	
5/6/2018 7:00	220	59	161	partly-cloudy-day	59	0.0038	
5/6/2018 8:00	338	155	183	cloudy	60	0.0167	
5/6/2018 9:00	617	352	265	cloudy	60	0.0224	
5/6/2018 10:00	1223	776	447	partly-cloudy-day	60	0.0157	
5/6/2018 11:00	1660	698	962	partly-cloudy-day	60	0.0065	
5/6/2018 12:00	1838	835	1003	cloudy	64	0.0019	
5/6/2018 13:00	1889	874	1015	cloudy	65	0.001	
5/6/2018 14:00	2153	986	1167	partly-cloudy-day	62	0	
5/6/2018 15:00	2033	868	1165	cloudy	69	0.0002	
5/6/2018 16:00	1878	808	1070	partly-cloudy-day	62	0	
5/6/2018 17:00	1677	766	911	cloudy	62	0	
5/6/2018 18:00	1298	533	765	partly-cloudy-day	61	0	
5/6/2018 19:00	861	399	462	cloudy	60	0.0017	
5/6/2018 20:00	697	330	367	partly-cloudy-night	59	0.0004	
5/6/2018 21:00	358	151	207	partly-cloudy-night	58	0.0048	
5/6/2018 22:00	234	118	116	partly-cloudy-night	57	0.0043	
5/6/2018 23:00	107	47	60	partly-cloudy-night	56	0	
5/7/2018 0:00	40	17	23	partly-cloudy-night	57	0	
5/7/2018 1:00	26	12	14	partly-cloudy-night	57	0	
5/7/2018 2:00	6	2	4	partly-cloudy-night	56	0	
5/7/2018 3:00	7	1	6	partly-cloudy-night	55	0	
5/7/2018 4:00	3	1	2	clear-night	54	0.0004	
5/7/2018 5:00	34	19	15	clear-night	53	0	
5/7/2018 6:00	144	67	77	clear-day	53	0	
5/7/2018 7:00	227	95	132	clear-day	54	0	
5/7/2018 8:00	466	180	286	clear-day	57	0	
5/7/2018 9:00	719	365	354	partly-cloudy-day	61	0.0002	
5/7/2018 10:00	1445	826	619	partly-cloudy-day	62	0	
5/7/2018 11:00	2035	1068	967	partly-cloudy-day	68	0	
5/7/2018 12:00	2206	983	1223	partly-cloudy-day	71	0	
5/7/2018 13:00	2150	948	1202	partly-cloudy-day	73	0.0002	
5/7/2018 14:00	2180	1018	1162	clear-day	75	0	
5/7/2018 15:00	2244	1045	1199	clear-day	76	0.0004	
5/7/2018 16:00	2285	1037	1248	partly-cloudy-day	75	0	
5/7/2018 17:00	2225	1064	1161	partly-cloudy-day	69	0	
5/7/2018 18:00	1968	1102	866	partly-cloudy-day	66	0	
5/7/2018 19:00	1389	693	696	partly-cloudy-day	64	0	
5/7/2018 20:00	853	316	537	partly-cloudy-night	61	0	
5/7/2018 21:00	425	166	259	partly-cloudy-night	60	0	
5/7/2018 22:00	163	65	98	partly-cloudy-night	58	0	
5/7/2018 23:00	92	36	56	clear-night	56	0	
5/8/2018 0:00	29	17	12	clear-night	55	0	
5/8/2018 1:00	29	16	13	clear-night	54	0	
5/8/2018 2:00	7	3	4	clear-night	53	0	
5/8/2018 3:00	7	0	7	clear-night	53	0	
5/8/2018 4:00	12	5	7	clear-night	52	0	
5/8/2018 5:00	59	38	21	clear-night	52	0	
5/8/2018 6:00	197	81	116	clear-day	51	0	
5/8/2018 7:00	324	135	189	clear-day	54	0	
5/8/2018 8:00	534	194	340	clear-day	56	0	
5/8/2018 9:00	719	342	377	clear-day	60	0	
5/8/2018 10:00	1227	672	555	clear-day	63	0	
5/8/2018 11:00	1752	848	904	clear-day	64	0	
5/8/2018 12:00	2010	969	1041	clear-day	66	0	
5/8/2018 13:00	2068	926	1142	clear-day	67	0	
5/8/2018 14:00	2087	891	1196	clear-day	67	0	
5/8/2018 15:00	2117	1010	1107	clear-day	68	0	
5/8/2018 16:00	2156	1035	1121	clear-day	67	0	
5/8/2018 17:00	1988	1062	926	clear-day	65	0	
5/8/2018 18:00	1822	1002	820	clear-day	64	0	
5/8/2018 19:00	1375	649	726	clear-day	62	0	
5/8/2018 20:00	882	356	526	clear-night	60	0	
5/8/2018 21:00	528	179	349	clear-night	58	0	
5/8/2018 22:00	215	80	135	clear-night	56	0	
5/8/2018 23:00	90	46	44	clear-night	55	0	
5/9/2018 0:00	44	26	18	clear-night	54	0	
5/9/2018 1:00	18	11	7	clear-night	53	0	
5/9/2018 2:00	13	8	5	clear-night	52	0	
5/9/2018 3:00	1	0	1	clear-night	52	0	
5/9/2018 4:00	4	1	3	clear-night	51	0	
5/9/2018 5:00	41	28	13	clear-night	51	0	
5/9/2018 6:00	219	104	115	clear-day	51	0	
5/9/2018 7:00	334	140	194	clear-day	53	0	
5/9/2018 8:00	518	196	322	clear-day	57	0	
5/9/2018 9:00	773	378	395	clear-day	62	0	
5/9/2018 10:00	1324	787	537	clear-day	65	0	
5/9/2018 11:00	1669	869	800	clear-day	68	0	
5/9/2018 12:00	1751	900	851	clear-day	71	0	
5/9/2018 13:00	1729	755	974	clear-day	71	0	
5/9/2018 14:00	1783	866	917	clear-day	69	0	
5/9/2018 15:00	1976	923	1053	clear-day	70	0	
5/9/2018 16:00	2017	989	1028	clear-day	70	0	
5/9/2018 17:00	1824	974	850	clear-day	70	0	
5/9/2018 18:00	1727	982	745	clear-day	67	0	
5/9/2018 19:00	1564	817	747	clear-day	64	0	
5/9/2018 20:00	858	341	517	clear-night	61	0	
5/9/2018 21:00	505	229	276	clear-night	58	0	
5/9/2018 22:00	255	131	124	clear-night	56	0	
5/9/2018 23:00	162	89	73	clear-night	55	0	
5/10/2018 0:00	46	19	27	partly-cloudy-night	53	0	
5/10/2018 1:00	24	14	10	partly-cloudy-night	53	0	
5/10/2018 2:00	3	0	3	partly-cloudy-night	52	0	
5/10/2018 3:00	7	3	4	cloudy	52	0	
5/10/2018 4:00	10	4	6	cloudy	53	0	
5/10/2018 5:00	51	38	13	cloudy	53	0	
5/10/2018 6:00	171	78	93	partly-cloudy-day	53	0	
5/10/2018 7:00	229	95	134	partly-cloudy-day	53	0	
5/10/2018 8:00	370	154	216	partly-cloudy-day	54	0	
5/10/2018 9:00	659	384	275	partly-cloudy-day	55	0	
5/10/2018 10:00	1273	722	551	partly-cloudy-day	59	0	
5/10/2018 11:00	1869	905	964	partly-cloudy-day	60	0	
5/10/2018 12:00	1917	869	1048	partly-cloudy-day	62	0	
5/10/2018 13:00	1575	675	900	partly-cloudy-day	60	0	
5/10/2018 14:00	1714	785	929	partly-cloudy-day	60	0	
5/10/2018 15:00	1820	884	936	partly-cloudy-day	66	0	
5/10/2018 16:00	1685	785	900	clear-day	63	0	
5/10/2018 17:00	1674	882	792	clear-day	64	0	
5/10/2018 18:00	1594	860	734	partly-cloudy-day	69	0.0073	
5/10/2018 19:00	1205	650	555	partly-cloudy-day	64	0	
5/10/2018 20:00	630	264	366	partly-cloudy-night	64	0.0171	
5/10/2018 21:00	242	128	114	rain	62	0.0513	
5/10/2018 22:00	87	59	28	rain	61	0.0851	
5/10/2018 23:00	87	75	12	partly-cloudy-night	61	0.0113	
5/11/2018 0:00	63	38	25	clear-night	60	0.0012	
5/11/2018 1:00	12	6	6	clear-night	59	0.0003	
5/11/2018 2:00	8	5	3	clear-night	59	0	
5/11/2018 3:00	10	8	2	clear-night	59	0.0004	
5/11/2018 4:00	7	5	2	partly-cloudy-night	60	0.0006	
5/11/2018 5:00	43	31	12	clear-night	60	0.0003	
5/11/2018 6:00	172	81	91	clear-day	60	0	
5/11/2018 7:00	273	116	157	clear-day	61	0.0013	
5/11/2018 8:00	516	201	315	clear-day	62	0	
5/11/2018 9:00	861	474	387	clear-day	62	0	
5/11/2018 10:00	1719	1015	704	clear-day	63	0	
5/11/2018 11:00	2108	1128	980	clear-day	64	0	
5/11/2018 12:00	2493	1283	1210	clear-day	64	0	
5/11/2018 13:00	2552	1214	1338	clear-day	66	0	
5/11/2018 14:00	2778	1290	1488	clear-day	68	0	
5/11/2018 15:00	2797	1251	1546	clear-day	70	0	
5/11/2018 16:00	2610	1199	1411	clear-day	71	0	
5/11/2018 17:00	2446	1226	1220	clear-day	72	0	
5/11/2018 18:00	2113	1123	990	clear-day	71	0	
5/11/2018 19:00	1643	882	761	clear-day	69	0	
5/11/2018 20:00	1153	484	669	clear-night	68	0	
5/11/2018 21:00	767	373	394	partly-cloudy-night	69	0	
5/11/2018 22:00	520	251	269	partly-cloudy-night	67	0.0007	
5/11/2018 23:00	353	179	174	partly-cloudy-night	65	0.0009	
5/12/2018 0:00	109	36	73	partly-cloudy-night	64	0	
5/12/2018 1:00	51	24	27	partly-cloudy-night	65	0	
5/12/2018 2:00	25	19	6	partly-cloudy-night	64	0.0034	
5/12/2018 3:00	7	2	5	partly-cloudy-night	63	0.0019	
5/12/2018 4:00	8	0	8	rain	60	0.0289	
5/12/2018 5:00	11	3	8	cloudy	56	0.0116	
5/12/2018 6:00	28	14	14	rain	54	0.1353	
5/12/2018 7:00	60	31	29	partly-cloudy-day	53	0.0134	
5/12/2018 8:00	168	76	92	partly-cloudy-day	53	0.0066	
5/12/2018 9:00	470	304	166	partly-cloudy-day	53	0.0056	
5/12/2018 10:00	761	389	372	cloudy	54	0.0026	
5/12/2018 11:00	2154	1325	829	rain	54	0.0438	
5/12/2018 12:00	1467	753	714	partly-cloudy-day	55	0.0106	
5/12/2018 13:00	1952	938	1014	partly-cloudy-day	55	0	
5/12/2018 14:00	2064	964	1100	partly-cloudy-day	56	0	
5/12/2018 15:00	2251	972	1279	cloudy	57	0	
5/12/2018 16:00	2299	1044	1255	cloudy	58	0	
5/12/2018 17:00	1873	786	1087	cloudy	58	0.0024	
5/12/2018 18:00	817	350	467	cloudy	56	0.0031	
5/12/2018 19:00	417	185	232	rain	55	0.1714	
5/12/2018 20:00	161	97	64	rain	54	0.0287	
5/12/2018 21:00	110	88	22	partly-cloudy-night	54	0.0128	
5/12/2018 22:00	85	57	28	cloudy	54	0.0008	
5/12/2018 23:00	106	65	41	cloudy	53	0	
5/13/2018 0:00	98	69	29				Mother's Day
5/13/2018 1:00	23	11	12	cloudy	52	0	Mother's Day
5/13/2018 2:00	10	8	2	cloudy	52	0	Mother's Day
5/13/2018 3:00	3	3	0	cloudy	52	0	Mother's Day
5/13/2018 4:00	4	2	2	cloudy	52	0	Mother's Day
5/13/2018 5:00	15	10	5	cloudy	52	0	Mother's Day
5/13/2018 6:00	51	32	19	cloudy	51	0	Mother's Day
5/13/2018 7:00	92	43	49	partly-cloudy-day	52	0	Mother's Day
5/13/2018 8:00	250	135	115	cloudy	52	0	Mother's Day
5/13/2018 9:00	587	355	232	partly-cloudy-day	52	0	Mother's Day
5/13/2018 10:00	1217	756	461	cloudy	53	0	Mother's Day
5/13/2018 11:00	1693	844	849	cloudy	53	0	Mother's Day
5/13/2018 12:00	1396	502	894	cloudy	53	0	Mother's Day
5/13/2018 13:00	805	397	408	cloudy	53	0.0208	Mother's Day
5/13/2018 14:00	751	344	407	rain	53	0.0392	Mother's Day
5/13/2018 15:00	1064	510	554	rain	53	0.197	Mother's Day
5/13/2018 16:00	1097	571	526	rain	53	0.1607	Mother's Day
5/13/2018 17:00	1114	563	551	partly-cloudy-day	53	0.0003	Mother's Day
5/13/2018 18:00	989	468	521	partly-cloudy-day	53	0.0007	Mother's Day
5/13/2018 19:00	686	300	386	partly-cloudy-day	53	0.0014	Mother's Day
5/13/2018 20:00	496	282	214	cloudy	53	0.0006	Mother's Day
5/13/2018 21:00	92	51	41	cloudy	52	0.0046	Mother's Day
5/13/2018 22:00	82	63	19	rain	52	0.2018	Mother's Day
5/13/2018 23:00	71	58	13	partly-cloudy-night	52	0.0064	Mother's Day
5/14/2018 0:00	14	6	8	cloudy	52	0.004	
5/14/2018 1:00	6	1	5	cloudy	52	0.017	
5/14/2018 2:00	6	5	1	cloudy	52	0.0111	
5/14/2018 3:00	2	1	1	cloudy	51	0.0129	
5/14/2018 4:00	1	0	1	partly-cloudy-night	52	0.0066	
5/14/2018 5:00	33	21	12	partly-cloudy-night	52	0.0054	
5/14/2018 6:00	85	37	48	partly-cloudy-day	52	0.001	
5/14/2018 7:00	165	76	89	partly-cloudy-day	53	0.0006	
5/14/2018 8:00	334	118	216	partly-cloudy-day	53	0.0005	
5/14/2018 9:00	627	341	286	partly-cloudy-day	54	0.0002	
5/14/2018 10:00	1203	698	505	partly-cloudy-day	56	0.0011	
5/14/2018 11:00	1946	965	981	cloudy	59	0.0027	
5/14/2018 12:00	2205	945	1260	partly-cloudy-day	60	0.0026	
5/14/2018 13:00	2409	1075	1334	cloudy	61	0	
5/14/2018 14:00	2258	1029	1229	partly-cloudy-day	63	0	
5/14/2018 15:00	2397	1104	1293	partly-cloudy-day	66	0.0022	
5/14/2018 16:00	2451	1186	1265	clear-day	68	0	
5/14/2018 17:00	2388	1273	1115	clear-day	68	0	
5/14/2018 18:00	2282	1201	1081	clear-day	66	0	
5/14/2018 19:00	1721	875	846	clear-day	63	0.0007	
5/14/2018 20:00	908	372	536	clear-day	61	0	
5/14/2018 21:00	515	170	345	clear-night	60	0	
5/14/2018 22:00	186	66	120	partly-cloudy-night	59	0	
5/14/2018 23:00	109	49	60	partly-cloudy-night	58	0	
5/15/2018 0:00	48	26	22	partly-cloudy-night	60	0	
5/15/2018 1:00	27	14	13	partly-cloudy-night	60	0	
5/15/2018 2:00	13	7	6	partly-cloudy-night	59	0	
5/15/2018 3:00	5	4	1	partly-cloudy-night	60	0	
5/15/2018 4:00	7	4	3	cloudy	60	0	
5/15/2018 5:00	35	25	10	cloudy	60	0	
5/15/2018 6:00	123	58	65	fog	60	0	
5/15/2018 7:00	232	102	130	fog	62	0	
5/15/2018 8:00	385	124	261	partly-cloudy-day	64	0	
5/15/2018 9:00	641	335	306	partly-cloudy-day	65	0	
5/15/2018 10:00	997	565	432	clear-day	70	0	
5/15/2018 11:00	1692	824	868	clear-day	75	0.0005	
5/15/2018 12:00	1714	772	942	clear-day	79	0	
5/15/2018 13:00	1738	758	980	clear-day	82	0	
5/15/2018 14:00	1634	669	965	clear-day	83	0	
5/15/2018 15:00	1709	814	895	clear-day	84	0	
5/15/2018 16:00	1726	798	928	partly-cloudy-day	84	0.0153	
5/15/2018 17:00	716	176	540	clear-day	84	0.02	
5/15/2018 18:00	172	118	54	rain	67	0.1686	
5/15/2018 19:00	125	99	26	rain	65	0.0796	
5/15/2018 20:00	306	182	124	rain	65	0.0464	
5/15/2018 21:00	202	100	102	clear-night	65	0.0055	
5/15/2018 22:00	152	75	77	partly-cloudy-night	65	0.0018	
5/15/2018 23:00	81	43	38	partly-cloudy-night	64	0	
5/16/2018 0:00	45	15	30	partly-cloudy-night	64	0	
5/16/2018 1:00	24	14	10	partly-cloudy-night	63	0	
5/16/2018 2:00	11	6	5	partly-cloudy-night	63	0	
5/16/2018 3:00	2	1	1	partly-cloudy-night	62	0	
5/16/2018 4:00	7	4	3	partly-cloudy-night	62	0	
5/16/2018 5:00	38	24	14	cloudy	62	0	
5/16/2018 6:00	126	68	58	partly-cloudy-day	62	0	
5/16/2018 7:00	232	89	143	partly-cloudy-day	62	0	
5/16/2018 8:00	344	131	213	cloudy	62	0	
5/16/2018 9:00	454	235	219	partly-cloudy-day	63	0.0003	
5/16/2018 10:00	848	458	390	partly-cloudy-day	64	0.002	
5/16/2018 11:00	1027	482	545	partly-cloudy-day	63	0.0007	
5/16/2018 12:00	905	343	562	partly-cloudy-day	62	0.0074	
5/16/2018 13:00	558	224	334	rain	60	0.0733	
5/16/2018 14:00	571	261	310	rain	60	0.028	
5/16/2018 15:00	518	220	298	rain	59	0.0458	
5/16/2018 16:00	510	284	226	rain	59	0.0395	
5/16/2018 17:00	511	277	234	rain	58	0.0451	
5/16/2018 18:00	357	237	120	rain	58	0.0533	
5/16/2018 19:00	296	163	133	rain	57	0.0271	
5/16/2018 20:00	275	156	119	cloudy	57	0.0141	
5/16/2018 21:00	174	104	70	cloudy	57	0.0082	
5/16/2018 22:00	89	62	27	cloudy	57	0.003	
5/16/2018 23:00	47	33	14	cloudy	56	0.0021	
5/17/2018 0:00	16	6	10	cloudy	56	0.0016	
5/17/2018 1:00	7	3	4	cloudy	56	0.0032	
5/17/2018 2:00	4	0	4	cloudy	56	0.0021	
5/17/2018 3:00	4	1	3	cloudy	56	0.0018	
5/17/2018 4:00	2	0	2	cloudy	55	0.0047	
5/17/2018 5:00	15	6	9	cloudy	56	0.0158	
5/17/2018 6:00	42	23	19	rain	56	0.0717	
5/17/2018 7:00	55	23	32	rain	57	0.1063	
5/17/2018 8:00	113	45	68	rain	57	0.06	
5/17/2018 9:00	209	102	107	partly-cloudy-day	58	0.018	
5/17/2018 10:00	593	387	206	partly-cloudy-day	59	0.012	
5/17/2018 11:00	1050	540	510	partly-cloudy-day	60	0.0093	
5/17/2018 12:00	1283	634	649	partly-cloudy-day	60	0.0044	
5/17/2018 13:00	1582	755	827	partly-cloudy-day	62	0.003	
5/17/2018 14:00	1759	844	915	partly-cloudy-day	64	0.0024	
5/17/2018 15:00	1910	816	1094	partly-cloudy-day	66	0.0005	
5/17/2018 16:00	2079	1050	1029	clear-day	68	0	
5/17/2018 17:00	2156	1054	1102	clear-day	69	0	
5/17/2018 18:00	1836	944	892	partly-cloudy-day	71	0.0012	
5/17/2018 19:00	1435	746	689	clear-day	68	0	
5/17/2018 20:00	939	414	525	clear-day	67	0	
5/17/2018 21:00	663	304	359	clear-night	65	0	
5/17/2018 22:00	344	131	213	clear-night	64	0	
5/17/2018 23:00	206	89	117	clear-night	64	0	
5/18/2018 0:00	86	40	46	clear-night	63	0	
5/18/2018 1:00	38	18	20	clear-night	62	0	
5/18/2018 2:00	20	11	9	clear-night	62	0	
5/18/2018 3:00	16	14	2	clear-night	63	0	
5/18/2018 4:00	13	5	8	clear-night	61	0	
5/18/2018 5:00	38	21	17	clear-night	61	0	
5/18/2018 6:00	133	66	67	partly-cloudy-day	61	0	
5/18/2018 7:00	219	108	111	partly-cloudy-day	63	0	
5/18/2018 8:00	360	127	233	partly-cloudy-day	63	0	
5/18/2018 9:00	588	321	267	partly-cloudy-day	62	0	
5/18/2018 10:00	1456	873	583	partly-cloudy-day	62	0.0002	
5/18/2018 11:00	1975	982	993	partly-cloudy-day	62	0	
5/18/2018 12:00	2023	863	1160	clear-day	63	0	
5/18/2018 13:00	2328	1006	1322	clear-day	62	0	
5/18/2018 14:00	2523	1181	1342	clear-day	62	0	
5/18/2018 15:00	2498	1132	1366	partly-cloudy-day	62	0	
5/18/2018 16:00	2247	972	1275	cloudy	63	0	
5/18/2018 17:00	2290	1075	1215	cloudy	62	0	
5/18/2018 18:00	1841	860	981	cloudy	61	0	
5/18/2018 19:00	1267	608	659	cloudy	60	0	
5/18/2018 20:00	801	374	427	cloudy	58	0	
5/18/2018 21:00	530	190	340	cloudy	57	0	
5/18/2018 22:00	324	139	185	cloudy	56	0	
5/18/2018 23:00	169	74	95	cloudy	56	0	
5/19/2018 0:00	65	26	39	cloudy	56	0	
5/19/2018 1:00	43	25	18	cloudy	55	0	
5/19/2018 2:00	18	13	5	cloudy	55	0	
5/19/2018 3:00	5	1	4	cloudy	54	0	
5/19/2018 4:00	6	4	2	cloudy	52	0.0002	
5/19/2018 5:00	10	9	1	cloudy	51	0.0022	
5/19/2018 6:00	29	16	13	cloudy	50	0.015	
5/19/2018 7:00	26	13	13	rain	50	0.04	
5/19/2018 8:00	48	28	20	rain	50	0.0562	
5/19/2018 9:00	227	140	87	rain	51	0.0303	
5/19/2018 10:00	762	511	251	rain	52	0.025	
5/19/2018 11:00	1282	799	483	rain	52	0.2226	
5/19/2018 12:00	539	224	315	rain	54	0.0328	
5/19/2018 13:00	321	172	149	rain	54	0.0678	
5/19/2018 14:00	574	324	250	rain	54	0.0989	
5/19/2018 15:00	938	532	406	cloudy	55	0.0167	
5/19/2018 16:00	1108	574	534	cloudy	55	0.0043	
5/19/2018 17:00	1182	608	574	cloudy	56	0.0026	
5/19/2018 18:00	892	424	468	cloudy	56	0.0019	
5/19/2018 19:00	755	366	389	cloudy	56	0.0027	
5/19/2018 20:00	487	234	253	cloudy	55	0.0013	
5/19/2018 21:00	232	85	147	cloudy	56	0.0005	
5/19/2018 22:00	112	52	60	fog	55	0.0003	
5/19/2018 23:00	77	50	27	cloudy	55	0.0031	
5/20/2018 0:00	29	11	18	cloudy	56	0.0006	
5/20/2018 1:00	13	6	7	cloudy	56	0.0013	
5/20/2018 2:00	15	4	11	fog	58	0.0024	
5/20/2018 3:00	7	2	5	fog	58	0.0043	
5/20/2018 4:00	6	5	1	fog	59	0.0035	
5/20/2018 5:00	20	11	9	fog	60	0.0007	
5/20/2018 6:00	33	18	15	partly-cloudy-day	60	0.0007	
5/20/2018 7:00	116	49	67	partly-cloudy-day	63	0.0024	
5/20/2018 8:00	357	232	125	partly-cloudy-day	66	0.0008	
5/20/2018 9:00	1012	621	391	partly-cloudy-day	69	0.0032	
5/20/2018 10:00	1942	1088	854	partly-cloudy-day	71	0.0012	
5/20/2018 11:00	2508	1282	1226	partly-cloudy-day	74	0	
5/20/2018 12:00	2796	1286	1510	partly-cloudy-day	76	0.0021	
5/20/2018 13:00	2962	1320	1642	partly-cloudy-day	79	0	
5/20/2018 14:00	2978	1281	1697	partly-cloudy-day	79	0	
5/20/2018 15:00	3205	1371	1834	partly-cloudy-day	80	0	
5/20/2018 16:00	2901	1297	1604	clear-day	80	0.0002	
5/20/2018 17:00	2840	1124	1716	partly-cloudy-day	79	0	
5/20/2018 18:00	2418	1074	1344	partly-cloudy-day	78	0	
5/20/2018 19:00	1951	955	996	partly-cloudy-day	75	0	
5/20/2018 20:00	1559	595	964	partly-cloudy-day	73	0	
5/20/2018 21:00	799	267	532	clear-night	71	0	
5/20/2018 22:00	360	117	243	clear-night	69	0	
5/20/2018 23:00	198	74	124	clear-night	68	0	
5/21/2018 0:00	83	26	57	clear-night	66	0	
5/21/2018 1:00	34	6	28	clear-night	64	0	
5/21/2018 2:00	14	8	6	clear-night	62	0	
5/21/2018 3:00	3	1	2	clear-night	61	0	
5/21/2018 4:00	9	2	7	clear-night	60	0	
5/21/2018 5:00	59	41	18	clear-night	59	0	
5/21/2018 6:00	164	68	96	clear-day	58	0	
5/21/2018 7:00	266	114	152	clear-day	60	0	
5/21/2018 8:00	561	214	347	clear-day	62	0	
5/21/2018 9:00	991	534	457	clear-day	64	0	
5/21/2018 10:00	1874	1062	812	clear-day	67	0	
5/21/2018 11:00	2245	1061	1184	clear-day	70	0	
5/21/2018 12:00	2611	1134	1477	clear-day	71	0	
5/21/2018 13:00	2473	1016	1457	clear-day	73	0	
5/21/2018 14:00	2457	1105	1352	clear-day	74	0	
5/21/2018 15:00	2433	1187	1246	clear-day	73	0	
5/21/2018 16:00	2497	1163	1334	clear-day	73	0	
5/21/2018 17:00	2531	1293	1238	clear-day	73	0	
5/21/2018 18:00	2247	1249	998	clear-day	72	0.0012	
5/21/2018 19:00	1861	1002	859	clear-day	70	0	
5/21/2018 20:00	1296	473	823	clear-day	67	0	
5/21/2018 21:00	642	170	472	clear-night	65	0	
5/21/2018 22:00	295	106	189	clear-night	63	0	
5/21/2018 23:00	155	71	84	clear-night	62	0	
5/22/2018 0:00	60	28	32	clear-night	61	0	
5/22/2018 1:00	38	18	20	clear-night	61	0	
5/22/2018 2:00	8	7	1	clear-night	60	0	
5/22/2018 3:00	12	6	6	clear-night	60	0	
5/22/2018 4:00	3	0	3	clear-night	60	0	
5/22/2018 5:00	53	31	22	clear-night	59	0	
5/22/2018 6:00	142	73	69	clear-day	60	0	
5/22/2018 7:00	222	83	139	clear-day	61	0	
5/22/2018 8:00	425	154	271	partly-cloudy-day	62	0	
5/22/2018 9:00	478	215	263	partly-cloudy-day	63	0	
5/22/2018 10:00	989	569	420	partly-cloudy-day	63	0.0047	
5/22/2018 11:00	1126	545	581	partly-cloudy-day	64	0	
5/22/2018 12:00	1143	483	660	cloudy	65	0	
5/22/2018 13:00	1093	449	644	partly-cloudy-day	64	0	
5/22/2018 14:00	923	343	580	cloudy	64	0	
5/22/2018 15:00	409	179	230	partly-cloudy-day	61	0.0171	
5/22/2018 16:00	319	155	164	rain	58	0.2865	
5/22/2018 17:00	477	278	199	rain	60	0.0293	
5/22/2018 18:00	549	340	209	partly-cloudy-day	58	0.0064	
5/22/2018 19:00	404	232	172	partly-cloudy-day	58	0.0006	
5/22/2018 20:00	327	167	160	partly-cloudy-day	58	0.0012	
5/22/2018 21:00	216	93	123	partly-cloudy-night	58	0.0011	
5/22/2018 22:00	122	63	59	cloudy	57	0.0005	
5/22/2018 23:00	70	30	40	cloudy	57	0.0002	
5/23/2018 0:00	44	18	26	partly-cloudy-night	57	0	
5/23/2018 1:00	22	18	4	partly-cloudy-night	58	0.0002	
5/23/2018 2:00	9	4	5	partly-cloudy-night	58	0.0018	
5/23/2018 3:00	2	1	1	rain	58	0.0361	
5/23/2018 4:00	2	0	2	rain	57	0.0977	
5/23/2018 5:00	13	9	4	rain	58	0.0397	
5/23/2018 6:00	104	55	49	partly-cloudy-day	59	0.0051	
5/23/2018 7:00	246	105	141	partly-cloudy-day	60	0.0022	
5/23/2018 8:00	496	208	288	partly-cloudy-day	61	0.0024	
5/23/2018 9:00	628	329	299	partly-cloudy-day	63	0.0107	
5/23/2018 10:00	1354	828	526	rain	67	0.2176	
5/23/2018 11:00	1859	994	865	partly-cloudy-day	70	0	
5/23/2018 12:00	1855	850	1005	partly-cloudy-day	71	0.0042	
5/23/2018 13:00	1989	896	1093	partly-cloudy-day	73	0	
5/23/2018 14:00	1974	913	1061	partly-cloudy-day	74	0	
5/23/2018 15:00	2150	931	1219	clear-day	77	0	
5/23/2018 16:00	2190	1082	1108	clear-day	79	0.0002	
5/23/2018 17:00	2324	1183	1141	clear-day	80	0	
5/23/2018 18:00	1910	1162	748	clear-day	80	0	
5/23/2018 19:00	1670	946	724	clear-day	79	0	
5/23/2018 20:00	1159	501	658	clear-day	77	0	
5/23/2018 21:00	751	310	441	clear-night	74	0	
5/23/2018 22:00	468	221	247	clear-night	72	0	
5/23/2018 23:00	179	60	119	clear-night	70	0	
5/24/2018 0:00	158	80	78	clear-night	69	0	
5/24/2018 1:00	23	13	10	clear-night	67	0	
5/24/2018 2:00	18	12	6	clear-night	65	0	
5/24/2018 3:00	3	0	3	clear-night	65	0	
5/24/2018 4:00	4	3	1	clear-night	64	0	
5/24/2018 5:00	65	37	28	clear-night	64	0	
5/24/2018 6:00	167	92	75	clear-day	63	0	
5/24/2018 7:00	242	97	145	clear-day	65	0	
5/24/2018 8:00	481	174	307	clear-day	67	0	
5/24/2018 9:00	752	373	379	clear-day	70	0	
5/24/2018 10:00	1424	833	591	clear-day	73	0	
5/24/2018 11:00	1748	919	829	clear-day	75	0.0022	
5/24/2018 12:00	1961	935	1026	clear-day	78	0	
5/24/2018 13:00	2006	835	1171	clear-day	78	0.0004	
5/24/2018 14:00	2118	954	1164	clear-day	80	0.0013	
5/24/2018 15:00	2032	928	1104	clear-day	81	0	
5/24/2018 16:00	1886	899	987	clear-day	80	0	
5/24/2018 17:00	2094	1042	1052	clear-day	81	0.0042	
5/24/2018 18:00	2061	1157	904	clear-day	80	0.0017	
5/24/2018 19:00	1800	987	813	clear-day	76	0	
5/24/2018 20:00	1456	546	910	clear-day	74	0	
5/24/2018 21:00	765	260	505	clear-night	72	0	
5/24/2018 22:00	400	145	255	clear-night	70	0	
5/24/2018 23:00	179	80	99	clear-night	69	0	
5/25/2018 0:00	71	37	34	clear-night	67	0	
5/25/2018 1:00	40	20	20	clear-night	66	0	
5/25/2018 2:00	17	14	3	clear-night	65	0	
5/25/2018 3:00	15	6	9	clear-night	64	0	
5/25/2018 4:00	11	6	5	clear-night	63	0	
5/25/2018 5:00	78	51	27	clear-night	62	0	
5/25/2018 6:00	169	77	92	clear-day	61	0	
5/25/2018 7:00	211	101	110	clear-day	63	0	
5/25/2018 8:00	490	201	289	clear-day	67	0	
5/25/2018 9:00	754	374	380	clear-day	71	0	
5/25/2018 10:00	1640	1064	576	clear-day	76	0	
5/25/2018 11:00	1976	904	1072	clear-day	79	0	
5/25/2018 12:00	2190	996	1194	clear-day	81	0.0043	
5/25/2018 13:00	2282	1047	1235	clear-day	83	0.0008	
5/25/2018 14:00	2134	969	1165	clear-day	84	0	
5/25/2018 15:00	2478	1127	1351	clear-day	84	0.0023	
5/25/2018 16:00	2459	1166	1293	clear-day	84	0.0027	
5/25/2018 17:00	2253	1060	1193	clear-day	84	0.0029	
5/25/2018 18:00	1943	998	945	clear-day	84	0.0025	
5/25/2018 19:00	1722	913	809	clear-day	83	0	
5/25/2018 20:00	1283	477	806	clear-day	81	0	
5/25/2018 21:00	982	324	658	clear-night	78	0	
5/25/2018 22:00	553	214	339	clear-night	77	0	
5/25/2018 23:00	283	113	170	clear-night	75	0	
5/26/2018 0:00	121	56	65	clear-night	75	0	
5/26/2018 1:00	82	33	49	clear-night	73	0	
5/26/2018 2:00	31	21	10	clear-night	73	0	
5/26/2018 3:00	9	4	5	clear-night	71	0	
5/26/2018 4:00	4	2	2	clear-night	71	0	
5/26/2018 5:00	48	39	9	clear-night	70	0	
5/26/2018 6:00	145	81	64	clear-day	70	0	
5/26/2018 7:00	270	118	152	clear-day	71	0	
5/26/2018 8:00	382	218	164	clear-day	73	0	
5/26/2018 9:00	997	679	318	clear-day	77	0	
5/26/2018 10:00	2023	1137	886	clear-day	80	0	
5/26/2018 11:00	2470	1371	1099	clear-day	83	0.0011	
5/26/2018 12:00	3020	1528	1492	clear-day	83	0	
5/26/2018 13:00	2898	1415	1483	clear-day	87	0	
5/26/2018 14:00	2888	1426	1462	clear-day	87	0	
5/26/2018 15:00	3025	1345	1680	clear-day	87	0	
5/26/2018 16:00	2619	1225	1394	clear-day	85	0.0002	
5/26/2018 17:00	2702	1330	1372	clear-day	85	0	
5/26/2018 18:00	2458	1144	1314	clear-day	84	0.006	
5/26/2018 19:00	2509	1184	1325	clear-day	83	0.0007	
5/26/2018 20:00	1899	709	1190	clear-day	79	0.0025	
5/26/2018 21:00	1060	336	724	clear-night	76	0	
5/26/2018 22:00	579	238	341	clear-night	75	0	
5/26/2018 23:00	375	185	190	clear-night	74	0	
5/27/2018 0:00	218	80	138	clear-night	75	0	
5/27/2018 1:00	72	41	31	clear-night	74	0	
5/27/2018 2:00	41	22	19	clear-night	73	0	
5/27/2018 3:00	24	12	12	clear-night	72	0	
5/27/2018 4:00	11	6	5	partly-cloudy-night	71	0.0005	
5/27/2018 5:00	24	14	10	rain	69	0.0255	
5/27/2018 6:00	34	13	21	rain	66	0.0369	
5/27/2018 7:00	34	18	16	rain	64	0.0441	
5/27/2018 8:00	73	36	37	rain	64	0.0781	
5/27/2018 9:00	63	38	25	rain	62	0.0937	
5/27/2018 10:00	416	253	163	rain	62	0.0662	
5/27/2018 11:00	479	268	211	cloudy	62	0.0154	
5/27/2018 12:00	885	575	310	cloudy	62	0.0118	
5/27/2018 13:00	1825	896	929	cloudy	62	0.0028	
5/27/2018 14:00	1380	725	655	partly-cloudy-day	61	0.0004	
5/27/2018 15:00	2102	1017	1085	cloudy	61	0.0006	
5/27/2018 16:00	2036	990	1046	cloudy	61	0	
5/27/2018 17:00	1978	962	1016	cloudy	60	0	
5/27/2018 18:00	1777	870	907	cloudy	59	0	
5/27/2018 19:00	1477	738	739	cloudy	59	0	
5/27/2018 20:00	1081	567	514	cloudy	58	0	
5/27/2018 21:00	486	186	300	cloudy	57	0	
5/27/2018 22:00	354	159	195	cloudy	57	0	
5/27/2018 23:00	182	92	90	cloudy	56	0.0023	
5/28/2018 0:00	124	45	79	cloudy	55	0.001	Memorial Day
5/28/2018 1:00	43	12	31	cloudy	56	0.0019	Memorial Day
5/28/2018 2:00	15	13	2	cloudy	55	0.0023	Memorial Day
5/28/2018 3:00	6	4	2	cloudy	54	0.001	Memorial Day
5/28/2018 4:00	7	5	2	cloudy	53	0.0006	Memorial Day
5/28/2018 5:00	38	26	12	cloudy	53	0.0013	Memorial Day
5/28/2018 6:00	57	29	28	cloudy	54	0.0031	Memorial Day
5/28/2018 7:00	125	71	54	partly-cloudy-day	55	0.0066	Memorial Day
5/28/2018 8:00	312	186	126	partly-cloudy-day	57	0.002	Memorial Day
5/28/2018 9:00	910	585	325	partly-cloudy-day	58	0.001	Memorial Day
5/28/2018 10:00	1735	978	757	partly-cloudy-day	60	0.0008	Memorial Day
5/28/2018 11:00	2595	1373	1222	partly-cloudy-day	61	0	Memorial Day
5/28/2018 12:00	3178	1669	1509	partly-cloudy-day	62	0	Memorial Day
5/28/2018 13:00	3210	1411	1799	partly-cloudy-day	64	0	Memorial Day
5/28/2018 14:00	3530	1681	1849	partly-cloudy-day	66	0.0014	Memorial Day
5/28/2018 15:00	3657	1640	2017	cloudy	66	0	Memorial Day
5/28/2018 16:00	3277	1520	1757	cloudy	66	0	Memorial Day
5/28/2018 17:00	2970	1301	1669	cloudy	66	0.0008	Memorial Day
5/28/2018 18:00	2464	1147	1317	cloudy	66	0	Memorial Day
5/28/2018 19:00	1908	804	1104	cloudy	64	0	Memorial Day
5/28/2018 20:00	1081	444	637	cloudy	62	0	Memorial Day
5/28/2018 21:00	580	180	400	cloudy	61	0	Memorial Day
5/28/2018 22:00	300	89	211	cloudy	61	0	Memorial Day
5/28/2018 23:00	131	39	92	cloudy	62	0	Memorial Day
5/29/2018 0:00	61	37	24	cloudy	62	0	
5/29/2018 1:00	27	9	18	partly-cloudy-night	63	0.0002	
5/29/2018 2:00	11	7	4	cloudy	63	0	
5/29/2018 3:00	8	4	4	partly-cloudy-night	63	0	
5/29/2018 4:00	8	6	2	cloudy	63	0	
5/29/2018 5:00	55	29	26	cloudy	63	0	
5/29/2018 6:00	108	48	60	partly-cloudy-day	64	0	
5/29/2018 7:00	183	90	93	partly-cloudy-day	65	0.0002	
5/29/2018 8:00	386	170	216	cloudy	66	0	
5/29/2018 9:00	672	349	323	partly-cloudy-day	69	0	
5/29/2018 10:00	1428	875	553	partly-cloudy-day	73	0.0002	
5/29/2018 11:00	1720	860	860	clear-day	76	0	
5/29/2018 12:00	1903	915	988	clear-day	79	0	
5/29/2018 13:00	1892	798	1094	clear-day	82	0	
5/29/2018 14:00	1951	919	1032	clear-day	85	0	
5/29/2018 15:00	1780	829	951	clear-day	84	0	
5/29/2018 16:00	1692	786	906	clear-day	84	0	
5/29/2018 17:00	1874	977	897	clear-day	84	0.0002	
5/29/2018 18:00	1728	991	737	clear-day	83	0	
5/29/2018 19:00	1520	888	632	clear-day	80	0	
5/29/2018 20:00	1233	542	691	clear-day	79	0	
5/29/2018 21:00	766	338	428	clear-night	77	0	
5/29/2018 22:00	396	152	244	clear-night	74	0	
5/29/2018 23:00	235	91	144	clear-night	73	0	
5/30/2018 0:00	120	67	53	clear-night	72	0	
5/30/2018 1:00	33	11	22	clear-night	70	0	
5/30/2018 2:00	19	14	5	clear-night	68	0	
5/30/2018 3:00	11	6	5	clear-night	66	0	
5/30/2018 4:00	14	8	6	clear-night	64	0	
5/30/2018 5:00	65	36	29	partly-cloudy-night	63	0	
5/30/2018 6:00	168	78	90	cloudy	63	0	
5/30/2018 7:00	236	114	122	cloudy	64	0	
5/30/2018 8:00	363	133	230	cloudy	65	0	
5/30/2018 9:00	759	432	327	cloudy	66	0	
5/30/2018 10:00	1433	901	532	cloudy	66	0	
5/30/2018 11:00	1677	830	847	cloudy	68	0	
5/30/2018 12:00	1715	823	892	cloudy	69	0	
5/30/2018 13:00	1871	791	1080	partly-cloudy-day	70	0	
5/30/2018 14:00	1777	804	973	partly-cloudy-day	70	0.0002	
5/30/2018 15:00	1832	855	977	partly-cloudy-day	70	0	
5/30/2018 16:00	1937	899	1038	clear-day	70	0	
5/30/2018 17:00	1854	922	932	clear-day	69	0	
5/30/2018 18:00	1727	952	775	clear-day	68	0	
5/30/2018 19:00	1336	606	730	clear-day	63	0	
5/30/2018 20:00	838	358	480	partly-cloudy-day	61	0	
5/30/2018 21:00	418	152	266	partly-cloudy-night	60	0	
5/30/2018 22:00	261	138	123	partly-cloudy-night	60	0.0002	
5/30/2018 23:00	139	57	82	partly-cloudy-night	61	0	
5/31/2018 0:00	65	39	26	partly-cloudy-night	62	0	
5/31/2018 1:00	23	13	10	partly-cloudy-night	62	0	
5/31/2018 2:00	11	5	6	partly-cloudy-night	62	0.0002	
5/31/2018 3:00	12	7	5	partly-cloudy-night	63	0	
5/31/2018 4:00	11	9	2	partly-cloudy-night	63	0	
5/31/2018 5:00	44	24	20	partly-cloudy-night	63	0	
5/31/2018 6:00	100	42	58	partly-cloudy-day	63	0	
5/31/2018 7:00	192	76	116	partly-cloudy-day	64	0	
5/31/2018 8:00	316	125	191	partly-cloudy-day	64	0.0004	
5/31/2018 9:00	485	257	228	partly-cloudy-day	65	0.0007	
5/31/2018 10:00	621	260	361	partly-cloudy-day	66	0.0013	
5/31/2018 11:00	583	349	234	partly-cloudy-day	65	0.0033	
5/31/2018 12:00	858	363	495	cloudy	65	0.0035	
5/31/2018 13:00	853	356	497	cloudy	65	0.0055	
5/31/2018 14:00	1071	516	555	cloudy	66	0.0097	
5/31/2018 15:00	1266	616	650	cloudy	66	0.0033	
5/31/2018 16:00	1288	650	638	cloudy	67	0.0035	
5/31/2018 17:00	1246	633	613	cloudy	67	0.0016	
5/31/2018 18:00	1032	560	472	cloudy	66	0.0004	
5/31/2018 19:00	786	424	362	cloudy	66	0	
5/31/2018 20:00	549	286	263	cloudy	65	0.001	
5/31/2018 21:00	325	122	203	cloudy	65	0.0007	
5/31/2018 22:00	163	88	75	cloudy	64	0	
5/31/2018 23:00	78	41	37	cloudy	64	0.0008	
6/1/2018 0:00	50	30	20	cloudy	64	0	
6/1/2018 1:00	36	16	20	cloudy	64	0.0002	
6/1/2018 2:00	11	6	5	cloudy	64	0	
6/1/2018 3:00	12	7	5	fog	64	0.001	
6/1/2018 4:00	15	13	2	cloudy	64	0.0004	
6/1/2018 5:00	22	10	12	cloudy	64	0.0048	
6/1/2018 6:00	52	28	24	cloudy	65	0.0097	
6/1/2018 7:00	124	55	69	cloudy	65	0.0035	
6/1/2018 8:00	157	70	87	cloudy	65	0.0114	
6/1/2018 9:00	447	244	203	rain	66	0.0305	
6/1/2018 10:00	1209	753	456	partly-cloudy-day	67	0.0134	
6/1/2018 11:00	1786	887	899	cloudy	70	0.0003	
6/1/2018 12:00	1973	906	1067	partly-cloudy-day	74	0.0003	
6/1/2018 13:00	1900	806	1094	partly-cloudy-day	77	0.0007	
6/1/2018 14:00	2038	923	1115	partly-cloudy-day	77	0.0016	
6/1/2018 15:00	1927	891	1036	partly-cloudy-day	77	0.0007	
6/1/2018 16:00	2128	1053	1075	partly-cloudy-day	79	0.0007	
6/1/2018 17:00	1855	933	922	clear-day	78	0.0007	
6/1/2018 18:00	1548	836	712	clear-day	78	0.0007	
6/1/2018 19:00	1369	726	643	clear-day	76	0.0007	
6/1/2018 20:00	975	413	562	clear-day	73	0.0005	
6/1/2018 21:00	666	254	412	clear-night	72	0.0004	
6/1/2018 22:00	428	196	232	clear-night	71	0.0002	
6/1/2018 23:00	313	148	165	clear-night	70	0.0005	
6/2/2018 0:00	162	99	63	clear-night	71	0.013	
6/2/2018 1:00	23	14	9	rain	69	0.0449	
6/2/2018 2:00	12	6	6	clear-night	70	0.0021	
6/2/2018 3:00	12	10	2	clear-night	70	0.0006	
6/2/2018 4:00	14	10	4	clear-night	69	0.0002	
6/2/2018 5:00	37	27	10	clear-night	69	0.0008	
6/2/2018 6:00	76	29	47	clear-day	69	0.0005	
6/2/2018 7:00	183	83	100	clear-day	71	0.0002	
6/2/2018 8:00	413	189	224	clear-day	73	0	
6/2/2018 9:00	817	461	356	clear-day	76	0.0002	
6/2/2018 10:00	1467	905	562	clear-day	79	0	
6/2/2018 11:00	2099	1167	932	clear-day	82	0	
6/2/2018 12:00	2223	1131	1092	clear-day	83	0.0002	
6/2/2018 13:00	2722	1005	1717	clear-day	83	0	
6/2/2018 14:00	3171	1066	2105	clear-day	83	0	
6/2/2018 15:00	2567	1165	1402	clear-day	83	0	
6/2/2018 16:00	2488	1035	1453	partly-cloudy-day	84	0.0002	
6/2/2018 17:00	2172	980	1192	clear-day	84	0	
6/2/2018 18:00	1744	946	798	clear-day	84	0	
6/2/2018 19:00	1810	801	1009	partly-cloudy-day	80	0.0002	
6/2/2018 20:00	1293	534	759	clear-day	77	0	
6/2/2018 21:00	757	246	511	partly-cloudy-night	76	0.0022	
6/2/2018 22:00	489	264	225	partly-cloudy-night	73	0	
6/2/2018 23:00	293	162	131	partly-cloudy-night	71	0.0037	
6/3/2018 0:00	150	92	58	partly-cloudy-night	70	0.0221	
6/3/2018 1:00	51	23	28	rain	66	0.0619	
6/3/2018 2:00	18	10	8	rain	64	0.0365	
6/3/2018 3:00	11	9	2	partly-cloudy-night	63	0.0214	
6/3/2018 4:00	9	2	7	partly-cloudy-night	62	0.0064	
6/3/2018 5:00	25	20	5	partly-cloudy-night	61	0.0014	
6/3/2018 6:00	77	33	44	partly-cloudy-day	61	0.0004	
6/3/2018 7:00	115	63	52	partly-cloudy-day	61	0.0007	
6/3/2018 8:00	283	177	106	partly-cloudy-day	61	0	
6/3/2018 9:00	817	447	370	partly-cloudy-day	61	0	
6/3/2018 10:00	1232	733	499	partly-cloudy-day	61	0	
6/3/2018 11:00	1703	867	836	partly-cloudy-day	61	0	
6/3/2018 12:00	1886	948	938	partly-cloudy-day	61	0.0003	
6/3/2018 13:00	2190	1008	1182	partly-cloudy-day	61	0.0002	
6/3/2018 14:00	2060	908	1152	partly-cloudy-day	61	0	
6/3/2018 15:00	2398	1111	1287	partly-cloudy-day	61	0	
6/3/2018 16:00	2491	1026	1465	partly-cloudy-day	61	0	
6/3/2018 17:00	2063	885	1178	partly-cloudy-day	61	0	
6/3/2018 18:00	1794	712	1082	partly-cloudy-day	60	0	
6/3/2018 19:00	1309	563	746	partly-cloudy-day	59	0	
6/3/2018 20:00	727	251	476	partly-cloudy-day	58	0	
6/3/2018 21:00	393	113	280	partly-cloudy-night	57	0.0002	
6/3/2018 22:00	76	23	53	partly-cloudy-night	55	0.0019	
6/3/2018 23:00	12	7	5	partly-cloudy-night	53	0.0227	
6/4/2018 0:00	3	2	1	rain	52	0.0572	
6/4/2018 1:00	3	2	1	rain	52	0.0848	
6/4/2018 2:00	4	2	2	rain	52	0.0448	
6/4/2018 3:00	1	0	1	rain	52	0.0263	
6/4/2018 4:00	1	0	1	cloudy	52	0.0165	
6/4/2018 5:00	9	5	4	cloudy	53	0.0126	
6/4/2018 6:00	41	21	20	rain	53	0.0402	
6/4/2018 7:00	76	40	36	rain	52	0.0486	
6/4/2018 8:00	188	72	116	cloudy	53	0.0171	
6/4/2018 9:00	367	179	188	cloudy	54	0.0017	
6/4/2018 10:00	797	435	362	cloudy	57	0	
6/4/2018 11:00	1297	726	571	partly-cloudy-day	60	0.0014	
6/4/2018 12:00	1546	693	853	cloudy	61	0	
6/4/2018 13:00	1613	793	820	cloudy	63	0	
6/4/2018 14:00	1825	850	975	partly-cloudy-day	66	0	
6/4/2018 15:00	1745	854	891	partly-cloudy-day	67	0	
6/4/2018 16:00	1709	774	935	partly-cloudy-day	69	0.0003	
6/4/2018 17:00	1799	975	824	partly-cloudy-day	70	0	
6/4/2018 18:00	1817	1078	739	partly-cloudy-day	69	0.0002	
6/4/2018 19:00	1393	753	640	partly-cloudy-day	68	0	
6/4/2018 20:00	1061	473	588	partly-cloudy-day	66	0	
6/4/2018 21:00	572	202	370	partly-cloudy-night	64	0	
6/4/2018 22:00	324	148	176	partly-cloudy-night	62	0	
6/4/2018 23:00	151	79	72	clear-night	62	0	
6/5/2018 0:00	48	20	28	clear-night	61	0	
6/5/2018 1:00	21	8	13	clear-night	60	0	
6/5/2018 2:00	7	3	4	clear-night	60	0.0002	
6/5/2018 3:00	5	4	1	clear-night	59	0	
6/5/2018 4:00	6	3	3	clear-night	58	0	
6/5/2018 5:00	63	35	28	clear-night	57	0	
6/5/2018 6:00	183	85	98	clear-day	57	0	
6/5/2018 7:00	284	115	169	clear-day	59	0	
6/5/2018 8:00	514	156	358	clear-day	62	0	
6/5/2018 9:00	707	299	408	clear-day	66	0	
6/5/2018 10:00	1176	694	482	partly-cloudy-day	69	0	
6/5/2018 11:00	1658	929	729	partly-cloudy-day	71	0	
6/5/2018 12:00	1842	902	940	partly-cloudy-day	72	0	
6/5/2018 13:00	1788	780	1008	partly-cloudy-day	73	0.0002	
6/5/2018 14:00	1783	802	981	partly-cloudy-day	72	0.0027	
6/5/2018 15:00	1754	781	973	cloudy	72	0	
6/5/2018 16:00	1578	785	793	cloudy	72	0	
6/5/2018 17:00	1777	939	838	partly-cloudy-day	72	0	
6/5/2018 18:00	1576	916	660	partly-cloudy-day	73	0	
6/5/2018 19:00	1350	784	566	partly-cloudy-day	71	0	
6/5/2018 20:00	1035	470	565	partly-cloudy-day	69	0	
6/5/2018 21:00	591	229	362	partly-cloudy-night	67	0.0003	
6/5/2018 22:00	378	192	186	clear-night	64	0	
6/5/2018 23:00	143	61	82	clear-night	63	0	
6/6/2018 0:00	66	40	26	partly-cloudy-night	62	0	
6/6/2018 1:00	27	15	12	partly-cloudy-night	61	0	
6/6/2018 2:00	12	8	4	partly-cloudy-night	60	0	
6/6/2018 3:00	11	9	2	partly-cloudy-night	59	0	
6/6/2018 4:00	20	10	10	partly-cloudy-night	59	0	
6/6/2018 5:00	53	34	19	partly-cloudy-night	59	0	
6/6/2018 6:00	218	103	115	partly-cloudy-day	59	0	
6/6/2018 7:00	302	113	189	partly-cloudy-day	60	0	
6/6/2018 8:00	472	177	295	partly-cloudy-day	60	0	
6/6/2018 9:00	648	261	387	cloudy	61	0	
6/6/2018 10:00	1177	639	538	cloudy	63	0	
6/6/2018 11:00	1558	883	675	cloudy	65	0	
6/6/2018 12:00	1571	639	932	partly-cloudy-day	67	0	
6/6/2018 13:00	1702	810	892	partly-cloudy-day	68	0	
6/6/2018 14:00	1670	853	817	partly-cloudy-day	67	0	
6/6/2018 15:00	1793	813	980	cloudy	68	0	
6/6/2018 16:00	1838	896	942	cloudy	68	0	
6/6/2018 17:00	1713	872	841	cloudy	66	0	
6/6/2018 18:00	1378	739	639	cloudy	64	0	
6/6/2018 19:00	1051	577	474	cloudy	63	0	
6/6/2018 20:00	755	344	411	partly-cloudy-day	61	0	
6/6/2018 21:00	458	172	286	cloudy	60	0	
6/6/2018 22:00	262	148	114	cloudy	60	0	
6/6/2018 23:00	136	65	71	cloudy	60	0	
6/7/2018 0:00	54	20	34	cloudy	60	0	
6/7/2018 1:00	15	9	6	cloudy	60	0	
6/7/2018 2:00	11	6	5	cloudy	59	0	
6/7/2018 3:00	12	3	9	cloudy	60	0	
6/7/2018 4:00	7	6	1	cloudy	60	0	
6/7/2018 5:00	46	25	21	cloudy	59	0	
6/7/2018 6:00	124	55	69	cloudy	59	0	
6/7/2018 7:00	213	101	112	partly-cloudy-day	60	0	
6/7/2018 8:00	353	121	232	cloudy	61	0.0002	
6/7/2018 9:00	510	244	266	cloudy	61	0	
6/7/2018 10:00	966	554	412	cloudy	63	0	
6/7/2018 11:00	1604	964	640	cloudy	65	0	
6/7/2018 12:00	1762	814	948	cloudy	67	0	
6/7/2018 13:00	1859	861	998	partly-cloudy-day	68	0	
6/7/2018 14:00	2041	867	1174	partly-cloudy-day	69	0	
6/7/2018 15:00	2102	975	1127	clear-day	69	0	
6/7/2018 16:00	2023	971	1052	clear-day	69	0	
6/7/2018 17:00	2094	1004	1090	partly-cloudy-day	67	0	
6/7/2018 18:00	1693	918	775	clear-day	66	0	
6/7/2018 19:00	1399	756	643	clear-day	64	0	
6/7/2018 20:00	999	423	576	clear-day	63	0	
6/7/2018 21:00	564	223	341	partly-cloudy-night	62	0	
6/7/2018 22:00	343	149	194	partly-cloudy-night	61	0	
6/7/2018 23:00	150	76	74	partly-cloudy-night	61	0	
6/8/2018 0:00	59	27	32	partly-cloudy-night	60	0	
6/8/2018 1:00	26	10	16	clear-night	60	0	
6/8/2018 2:00	15	4	11	clear-night	59	0	
6/8/2018 3:00	8	5	3	clear-night	59	0	
6/8/2018 4:00	6	4	2	clear-night	58	0	
6/8/2018 5:00	153	133	20	clear-night	58	0	
6/8/2018 6:00	215	101	114	clear-day	58	0	
6/8/2018 7:00	288	96	192	clear-day	60	0	
6/8/2018 8:00	462	171	291	clear-day	63	0.0002	
6/8/2018 9:00	572	292	280	clear-day	67	0	
6/8/2018 10:00	1318	720	598	clear-day	71	0	
6/8/2018 11:00	1748	973	775	clear-day	74	0	
6/8/2018 12:00	1900	928	972	clear-day	78	0	
6/8/2018 13:00	1959	956	1003	partly-cloudy-day	79	0	
6/8/2018 14:00	2127	1020	1107	partly-cloudy-day	79	0	
6/8/2018 15:00	2075	1028	1047	partly-cloudy-day	79	0	
6/8/2018 16:00	2284	1065	1219	partly-cloudy-day	77	0	
6/8/2018 17:00	1963	1103	860	partly-cloudy-day	79	0	
6/8/2018 18:00	1709	950	759	partly-cloudy-day	78	0	
6/8/2018 19:00	1516	810	706	partly-cloudy-day	78	0	
6/8/2018 20:00	1284	591	693	partly-cloudy-day	78	0	
6/8/2018 21:00	806	291	515	partly-cloudy-night	76	0	
6/8/2018 22:00	400	151	249	partly-cloudy-night	74	0	
6/8/2018 23:00	274	114	160	partly-cloudy-night	73	0	
6/9/2018 0:00	150	74	76	partly-cloudy-night	72	0	
6/9/2018 1:00	71	46	25	clear-night	70	0	
6/9/2018 2:00	38	20	18	clear-night	70	0	
6/9/2018 3:00	15	10	5	clear-night	69	0.0002	
6/9/2018 4:00	17	11	6	clear-night	68	0	
6/9/2018 5:00	58	35	23	clear-night	67	0	
6/9/2018 6:00	121	57	64	clear-day	67	0	
6/9/2018 7:00	184	80	104	clear-day	68	0	
6/9/2018 8:00	546	276	270	clear-day	69	0	
6/9/2018 9:00	742	417	325	clear-day	72	0	
6/9/2018 10:00	1539	929	610	clear-day	74	0	
6/9/2018 11:00	2084	1239	845	clear-day	76	0	
6/9/2018 12:00	2318	1179	1139	clear-day	77	0	
6/9/2018 13:00	2591	1236	1355	clear-day	79	0	
6/9/2018 14:00	2854	1382	1472	partly-cloudy-day	79	0	
6/9/2018 15:00	3062	1495	1567	clear-day	79	0	
6/9/2018 16:00	2944	1252	1692	partly-cloudy-day	75	0	
6/9/2018 17:00	2681	1290	1391	clear-day	77	0	
6/9/2018 18:00	2434	1104	1330	clear-day	75	0	
6/9/2018 19:00	2084	921	1163	clear-day	72	0	
6/9/2018 20:00	1606	640	966	partly-cloudy-day	71	0	
6/9/2018 21:00	887	280	607	clear-night	69	0	
6/9/2018 22:00	493	204	289	clear-night	69	0	
6/9/2018 23:00	345	166	179	clear-night	68	0	
6/10/2018 0:00	169	74	95	clear-night	69	0.0002	
6/10/2018 1:00	91	44	47	partly-cloudy-night	70	0	
6/10/2018 2:00	50	25	25	partly-cloudy-night	69	0	
6/10/2018 3:00	15	5	10	cloudy	69	0	
6/10/2018 4:00	11	6	5	partly-cloudy-night	69	0	
6/10/2018 5:00	47	33	14	partly-cloudy-night	69	0	
6/10/2018 6:00	75	26	49	partly-cloudy-day	68	0	
6/10/2018 7:00	113	56	57	partly-cloudy-day	68	0	
6/10/2018 8:00	247	129	118	cloudy	67	0	
6/10/2018 9:00	440	250	190	partly-cloudy-day	67	0.0006	
6/10/2018 10:00	1126	665	461	partly-cloudy-day	67	0	
6/10/2018 11:00	1607	768	839	partly-cloudy-day	68	0	
6/10/2018 12:00	1737	959	778	partly-cloudy-day	69	0	
6/10/2018 13:00	1928	841	1087	partly-cloudy-day	69	0.0012	
6/10/2018 14:00	2088	1034	1054	partly-cloudy-day	68	0.0013	
6/10/2018 15:00	2127	928	1199	cloudy	67	0.0011	
6/10/2018 16:00	1897	737	1160	cloudy	67	0.0023	
6/10/2018 17:00	1413	600	813	cloudy	65	0.0035	
6/10/2018 18:00	1333	585	748	partly-cloudy-day	64	0.0027	
6/10/2018 19:00	1027	491	536	partly-cloudy-day	64	0.0005	
6/10/2018 20:00	698	299	399	partly-cloudy-day	63	0.0004	
6/10/2018 21:00	446	182	264	partly-cloudy-night	61	0.0013	
6/10/2018 22:00	229	87	142	cloudy	61	0.0027	
6/10/2018 23:00	75	24	51	partly-cloudy-night	61	0.002	
6/11/2018 0:00	24	8	16	cloudy	59	0.0042	
6/11/2018 1:00	10	7	3	cloudy	58	0.0101	
6/11/2018 2:00	5	4	1	partly-cloudy-night	57	0.0116	
6/11/2018 3:00	6	3	3	cloudy	57	0.0082	
6/11/2018 4:00	5	1	4	partly-cloudy-night	57	0.003	
6/11/2018 5:00	38	23	15	partly-cloudy-night	57	0.0006	
6/11/2018 6:00	119	54	65	partly-cloudy-day	58	0.0008	
6/11/2018 7:00	240	98	142	partly-cloudy-day	58	0.0002	
6/11/2018 8:00	386	159	227	partly-cloudy-day	60	0.0026	
6/11/2018 9:00	632	344	288	partly-cloudy-day	62	0	
6/11/2018 10:00	1182	611	571	clear-day	64	0	
6/11/2018 11:00	1764	839	925	clear-day	66	0	
6/11/2018 12:00	1937	907	1030	clear-day	67	0	
6/11/2018 13:00	1984	873	1111	clear-day	69	0	
6/11/2018 14:00	2270	1009	1261	clear-day	69	0	
6/11/2018 15:00	2201	1057	1144	clear-day	69	0	
6/11/2018 16:00	2276	1155	1121	clear-day	69	0	
6/11/2018 17:00	2208	1156	1052	clear-day	68	0	
6/11/2018 18:00	1968	1175	793	clear-day	67	0	
6/11/2018 19:00	1866	1104	762	clear-day	65	0	
6/11/2018 20:00	1153	463	690	clear-day	63	0	
6/11/2018 21:00	713	246	467	clear-night	61	0	
6/11/2018 22:00	235	95	140	clear-night	60	0	
6/11/2018 23:00	158	71	87	clear-night	59	0	
6/12/2018 0:00	70	32	38	clear-night	58	0	
6/12/2018 1:00	29	14	15	clear-night	58	0	
6/12/2018 2:00	11	3	8	clear-night	57	0.0002	
6/12/2018 3:00	4	0	4	clear-night	56	0	
6/12/2018 4:00	3	1	2	clear-night	56	0	
6/12/2018 5:00	67	38	29	clear-night	55	0	
6/12/2018 6:00	178	86	92	clear-day	55	0	
6/12/2018 7:00	262	109	153	clear-day	59	0	
6/12/2018 8:00	516	145	371	clear-day	61	0	
6/12/2018 9:00	717	391	326	clear-day	63	0	
6/12/2018 10:00	1425	868	557	clear-day	66	0	
6/12/2018 11:00	1589	784	805	clear-day	69	0	
6/12/2018 12:00	1807	857	950	clear-day	70	0	
6/12/2018 13:00	2003	961	1042	clear-day	71	0	
6/12/2018 14:00	2190	1018	1172	clear-day	72	0	
6/12/2018 15:00	2154	929	1225	clear-day	72	0	
6/12/2018 16:00	1893	964	929	clear-day	71	0	
6/12/2018 17:00	1975	1078	897	clear-day	71	0	
6/12/2018 18:00	1835	1022	813	clear-day	70	0	
6/12/2018 19:00	1437	791	646	clear-day	67	0	
6/12/2018 20:00	1098	514	584	clear-day	66	0	
6/12/2018 21:00	597	220	377	clear-night	64	0	
6/12/2018 22:00	285	122	163	clear-night	64	0	
6/12/2018 23:00	171	88	83	clear-night	63	0	
6/13/2018 0:00	64	35	29	clear-night	63	0	
6/13/2018 1:00	23	16	7	partly-cloudy-night	62	0	
6/13/2018 2:00	19	6	13	partly-cloudy-night	62	0	
6/13/2018 3:00	10	6	4	partly-cloudy-night	62	0	
6/13/2018 4:00	10	6	4	cloudy	63	0	
6/13/2018 5:00	36	19	17	cloudy	63	0	
6/13/2018 6:00	148	66	82	partly-cloudy-day	64	0	
6/13/2018 7:00	168	68	100	cloudy	65	0	
6/13/2018 8:00	327	120	207	cloudy	66	0	
6/13/2018 9:00	485	272	213	cloudy	67	0	
6/13/2018 10:00	806	458	348	cloudy	69	0	
6/13/2018 11:00	984	537	447	cloudy	69	0.0004	
6/13/2018 12:00	985	396	589	partly-cloudy-day	69	0.0009	
6/13/2018 13:00	744	348	396	partly-cloudy-day	69	0.0072	
6/13/2018 14:00	1059	511	548	cloudy	69	0.0119	
6/13/2018 15:00	1152	600	552	cloudy	71	0	
6/13/2018 16:00	1208	610	598	cloudy	73	0	
6/13/2018 17:00	1260	661	599	partly-cloudy-day	74	0	
6/13/2018 18:00	1111	641	470	cloudy	75	0	
6/13/2018 19:00	879	509	370	partly-cloudy-day	76	0	
6/13/2018 20:00	759	442	317	partly-cloudy-day	75	0	
6/13/2018 21:00	525	192	333	partly-cloudy-night	74	0	
6/13/2018 22:00	338	171	167	clear-night	74	0	
6/13/2018 23:00	161	88	73	clear-night	74	0	
6/14/2018 0:00	65	32	33	partly-cloudy-night	74	0	
6/14/2018 1:00	31	18	13	partly-cloudy-night	73	0.0049	
6/14/2018 2:00	65	48	17	partly-cloudy-night	72	0.0054	
6/14/2018 3:00	4	3	1	partly-cloudy-night	72	0.0004	
6/14/2018 4:00	16	9	7	partly-cloudy-night	69	0	
6/14/2018 5:00	58	34	24	clear-night	68	0	
6/14/2018 6:00	177	86	91	clear-day	67	0.0006	
6/14/2018 7:00	258	108	150	clear-day	67	0	
6/14/2018 8:00	496	173	323	clear-day	68	0	
6/14/2018 9:00	847	490	357	clear-day	70	0	
6/14/2018 10:00	1188	719	469	clear-day	73	0	
6/14/2018 11:00	1749	849	900	clear-day	77	0	
6/14/2018 12:00	1775	801	974	clear-day	79	0	
6/14/2018 13:00	2077	802	1275	clear-day	79	0	
6/14/2018 14:00	1971	862	1109	clear-day	81	0	
6/14/2018 15:00	2009	907	1102	clear-day	82	0	
6/14/2018 16:00	1882	910	972	clear-day	84	0	
6/14/2018 17:00	1864	989	875	clear-day	84	0	
6/14/2018 18:00	1579	884	695	partly-cloudy-day	82	0	
6/14/2018 19:00	1558	905	653	clear-day	81	0	
6/14/2018 20:00	1211	534	677	clear-day	79	0	
6/14/2018 21:00	805	290	515	clear-night	77	0	
6/14/2018 22:00	432	195	237	clear-night	75	0	
6/14/2018 23:00	298	183	115	clear-night	72	0	
6/15/2018 0:00	114	55	59	clear-night	70	0	
6/15/2018 1:00	30	17	13	clear-night	68	0	
6/15/2018 2:00	12	11	1	clear-night	67	0	
6/15/2018 3:00	10	4	6	clear-night	66	0	
6/15/2018 4:00	10	7	3	clear-night	65	0	
6/15/2018 5:00	62	36	26	clear-night	64	0	
6/15/2018 6:00	154	74	80	clear-day	63	0	
6/15/2018 7:00	289	114	175	clear-day	63	0	
6/15/2018 8:00	484	175	309	clear-day	64	0	
6/15/2018 9:00	664	335	329	partly-cloudy-day	66	0	
6/15/2018 10:00	1148	714	434	partly-cloudy-day	68	0	
6/15/2018 11:00	1666	893	773	partly-cloudy-day	70	0	
6/15/2018 12:00	2128	925	1203	partly-cloudy-day	71	0	
6/15/2018 13:00	2082	921	1161	partly-cloudy-day	71	0	
6/15/2018 14:00	2136	1016	1120	partly-cloudy-day	73	0	
6/15/2018 15:00	2189	1117	1072	partly-cloudy-day	74	0	
6/15/2018 16:00	2118	1056	1062	partly-cloudy-day	74	0	
6/15/2018 17:00	1609	814	795	partly-cloudy-day	74	0	
6/15/2018 18:00	1189	1189	0	partly-cloudy-day	74	0	
6/15/2018 19:00	816	816	0	partly-cloudy-day	73	0	
6/15/2018 20:00	861	861	0	clear-day	72	0	
6/15/2018 21:00	635	635	0	partly-cloudy-night	69	0	
6/15/2018 22:00	370	370	0	partly-cloudy-night	67	0	
6/15/2018 23:00	276	276	0	partly-cloudy-night	67	0	
6/16/2018 0:00	182	93	89	clear-night	66	0	
6/16/2018 1:00	84	50	34	clear-night	64	0	
6/16/2018 2:00	37	21	16	clear-night	63	0	
6/16/2018 3:00	19	11	8	clear-night	63	0	
6/16/2018 4:00	13	11	2	clear-night	61	0	
6/16/2018 5:00	82	53	29	clear-night	61	0	
6/16/2018 6:00	95	43	52	clear-day	61	0	
6/16/2018 7:00	262	117	145	clear-day	64	0	
6/16/2018 8:00	362	191	171	clear-day	67	0	
6/16/2018 9:00	836	553	283	clear-day	71	0	
6/16/2018 10:00	1368	794	574	clear-day	74	0	
6/16/2018 11:00	1985	1102	883	clear-day	77	0	
6/16/2018 12:00	2452	1247	1205	clear-day	79	0	
6/16/2018 13:00	2728	1366	1362	clear-day	80	0	
6/16/2018 14:00	2698	1177	1521	clear-day	81	0	
6/16/2018 15:00	2918	1319	1599	clear-day	81	0	
6/16/2018 16:00	2623	1161	1462	clear-day	82	0	
6/16/2018 17:00	2414	1125	1289	clear-day	82	0	
6/16/2018 18:00	2231	1056	1175	partly-cloudy-day	81	0.0009	
6/16/2018 19:00	2241	1155	1086	clear-day	78	0	
6/16/2018 20:00	1896	753	1143	clear-day	77	0	
6/16/2018 21:00	1247	355	892	clear-night	74	0	
6/16/2018 22:00	665	254	411	clear-night	72	0	
6/16/2018 23:00	427	197	230	partly-cloudy-night	70	0.0018	
6/17/2018 0:00	261	164	97	clear-night	69	0	Father's Day
6/17/2018 1:00	124	79	45	clear-night	68	0	Father's Day
6/17/2018 2:00	58	36	22	clear-night	66	0	Father's Day
6/17/2018 3:00	16	11	5	clear-night	66	0	Father's Day
6/17/2018 4:00	20	11	9	clear-night	65	0	Father's Day
6/17/2018 5:00	115	55	60	clear-night	65	0	Father's Day
6/17/2018 6:00	133	67	66	clear-day	63	0	Father's Day
6/17/2018 7:00	211	96	115	clear-day	67	0	Father's Day
6/17/2018 8:00	305	177	128	clear-day	71	0	Father's Day
6/17/2018 9:00	809	517	292	clear-day	75	0	Father's Day
6/17/2018 10:00	1136	633	503	clear-day	78	0	Father's Day
6/17/2018 11:00	1784	902	882	clear-day	82	0	Father's Day
6/17/2018 12:00	1848	945	903	clear-day	83	0	Father's Day
6/17/2018 13:00	2037	918	1119	clear-day	86	0	Father's Day
6/17/2018 14:00	2038	897	1141	clear-day	86	0	Father's Day
6/17/2018 15:00	1892	902	990	clear-day	87	0	Father's Day
6/17/2018 16:00	1980	966	1014	clear-day	87	0	Father's Day
6/17/2018 17:00	1862	911	951	clear-day	84	0	Father's Day
6/17/2018 18:00	1765	871	894	clear-day	83	0	Father's Day
6/17/2018 19:00	1881	909	972	clear-day	81	0	Father's Day
6/17/2018 20:00	1496	613	883	clear-day	80	0	Father's Day
6/17/2018 21:00	1007	400	607	clear-night	77	0	Father's Day
6/17/2018 22:00	685	289	396	clear-night	76	0	Father's Day
6/17/2018 23:00	353	168	185	clear-night	74	0	Father's Day
6/18/2018 0:00	141	77	64	clear-night	72	0	
6/18/2018 1:00	35	10	25	clear-night	72	0	
6/18/2018 2:00	8	5	3	clear-night	71	0	
6/18/2018 3:00	11	6	5	clear-night	70	0	
6/18/2018 4:00	10	3	7	clear-night	70	0	
6/18/2018 5:00	45	22	23	clear-night	70	0	
6/18/2018 6:00	134	70	64	clear-day	69	0	
6/18/2018 7:00	263	109	154	clear-day	71	0	
6/18/2018 8:00	413	172	241	clear-day	73	0	
6/18/2018 9:00	577	292	285	clear-day	76	0	
6/18/2018 10:00	888	487	401	clear-day	80	0	
6/18/2018 11:00	1342	617	725	clear-day	82	0	
6/18/2018 12:00	1191	594	597	clear-day	85	0	
6/18/2018 13:00	1195	553	642	clear-day	87	0	
6/18/2018 14:00	1316	610	706	partly-cloudy-day	86	0	
6/18/2018 15:00	1230	630	600	partly-cloudy-day	88	0	
6/18/2018 16:00	1356	701	655	partly-cloudy-day	88	0	
6/18/2018 17:00	1522	799	723	partly-cloudy-day	89	0	
6/18/2018 18:00	1437	844	593	partly-cloudy-day	88	0	
6/18/2018 19:00	1336	759	577	partly-cloudy-day	87	0	
6/18/2018 20:00	983	383	600	partly-cloudy-day	85	0	
6/18/2018 21:00	154	61	93	rain	76	0.0692	
6/18/2018 22:00	232	113	119	rain	75	0.0504	
6/18/2018 23:00	139	52	87	clear-night	75	0.0037	
6/19/2018 0:00	57	23	34	clear-night	75	0	
6/19/2018 1:00	17	6	11	partly-cloudy-night	75	0.0021	
6/19/2018 2:00	5	4	1	partly-cloudy-night	75	0.0112	
6/19/2018 3:00	8	0	8	partly-cloudy-night	75	0.0125	
6/19/2018 4:00	5	1	4	partly-cloudy-night	75	0.002	
6/19/2018 5:00	85	52	33	clear-night	75	0.0003	
6/19/2018 6:00	187	84	103	clear-day	74	0	
6/19/2018 7:00	270	130	140	partly-cloudy-day	76	0.0008	
6/19/2018 8:00	379	120	259	partly-cloudy-day	78	0	
6/19/2018 9:00	520	269	251	partly-cloudy-day	80	0	
6/19/2018 10:00	1058	589	469	partly-cloudy-day	82	0	
6/19/2018 11:00	1166	600	566	partly-cloudy-day	82	0	
6/19/2018 12:00	1317	576	741	partly-cloudy-day	83	0	
6/19/2018 13:00	1530	655	875	partly-cloudy-day	84	0	
6/19/2018 14:00	1437	572	865	clear-day	85	0	
6/19/2018 15:00	1616	839	777	clear-day	86	0	
6/19/2018 16:00	1409	639	770	clear-day	86	0.002	
6/19/2018 17:00	1397	781	616	clear-day	86	0	
6/19/2018 18:00	1498	912	586	clear-day	86	0	
6/19/2018 19:00	1235	736	499	clear-day	84	0	
6/19/2018 20:00	1273	635	638	clear-day	82	0	
6/19/2018 21:00	917	332	585	clear-night	79	0	
6/19/2018 22:00	412	156	256	clear-night	77	0	
6/19/2018 23:00	184	76	108	clear-night	75	0	
6/20/2018 0:00	180	134	46	clear-night	74	0	
6/20/2018 1:00	20	12	8	clear-night	73	0	
6/20/2018 2:00	13	8	5	clear-night	72	0	
6/20/2018 3:00	12	3	9	clear-night	71	0	
6/20/2018 4:00	11	8	3	clear-night	70	0	
6/20/2018 5:00	76	43	33	clear-night	69	0	
6/20/2018 6:00	214	100	114	clear-day	69	0	
6/20/2018 7:00	296	119	177	clear-day	69	0	
6/20/2018 8:00	452	146	306	clear-day	70	0	
6/20/2018 9:00	578	351	227	clear-day	71	0	
6/20/2018 10:00	973	489	484	clear-day	73	0	
6/20/2018 11:00	1248	683	565	clear-day	76	0	
6/20/2018 12:00	1347	608	739	partly-cloudy-day	77	0	
6/20/2018 13:00	1493	647	846	partly-cloudy-day	77	0	
6/20/2018 14:00	1579	722	857	partly-cloudy-day	78	0	
6/20/2018 15:00	1673	691	982	partly-cloudy-day	80	0	
6/20/2018 16:00	1594	748	846	partly-cloudy-day	80	0	
6/20/2018 17:00	1579	900	679	partly-cloudy-day	78	0	
6/20/2018 18:00	1695	921	774	partly-cloudy-day	77	0	
6/20/2018 19:00	1307	686	621	partly-cloudy-day	75	0	
6/20/2018 20:00	1077	458	619	partly-cloudy-day	74	0	
6/20/2018 21:00	608	227	381	partly-cloudy-night	73	0	
6/20/2018 22:00	369	191	178	cloudy	73	0	
6/20/2018 23:00	191	127	64	cloudy	72	0	
6/21/2018 0:00	64	39	25	cloudy	71	0	
6/21/2018 1:00	16	8	8	cloudy	70	0.0175	
6/21/2018 2:00	8	4	4	rain	68	0.0761	
6/21/2018 3:00	1	0	1	rain	67	0.0723	
6/21/2018 4:00	7	2	5	rain	66	0.041	
6/21/2018 5:00	99	26	73	cloudy	66	0.0205	
6/21/2018 6:00	81	31	50	partly-cloudy-day	66	0.0083	
6/21/2018 7:00	131	57	74	cloudy	66	0.0065	
6/21/2018 8:00	253	108	145	cloudy	66	0.0026	
6/21/2018 9:00	378	205	173	cloudy	68	0.0008	
6/21/2018 10:00	958	631	327	partly-cloudy-day	71	0.0037	
6/21/2018 11:00	1236	670	566	partly-cloudy-day	73	0.0008	
6/21/2018 12:00	1427	720	707	partly-cloudy-day	76	0	
6/21/2018 13:00	1824	778	1046	clear-day	79	0.0002	
6/21/2018 14:00	1486	628	858	partly-cloudy-day	80	0.0026	
6/21/2018 15:00	1599	733	866	partly-cloudy-day	81	0	
6/21/2018 16:00	1620	823	797	clear-day	83	0	
6/21/2018 17:00	1673	927	746	clear-day	83	0	
6/21/2018 18:00	1659	957	702	clear-day	81	0	
6/21/2018 19:00	1285	808	477	clear-day	80	0	
6/21/2018 20:00	1234	579	655	clear-day	78	0	
6/21/2018 21:00	947	302	645	clear-night	76	0	
6/21/2018 22:00	583	284	299	partly-cloudy-night	74	0	
6/21/2018 23:00	320	167	153	partly-cloudy-night	74	0	
6/22/2018 0:00	117	59	58	partly-cloudy-night	73	0	
6/22/2018 1:00	56	24	32	partly-cloudy-night	70	0	
6/22/2018 2:00	21	12	9	partly-cloudy-night	69	0	
6/22/2018 3:00	11	8	3	partly-cloudy-night	68	0	
6/22/2018 4:00	7	4	3	partly-cloudy-night	67	0	
6/22/2018 5:00	73	37	36	partly-cloudy-night	67	0	
6/22/2018 6:00	146	71	75	partly-cloudy-day	66	0.0003	
6/22/2018 7:00	260	117	143	partly-cloudy-day	67	0	
6/22/2018 8:00	384	147	237	partly-cloudy-day	68	0	
6/22/2018 9:00	647	351	296	partly-cloudy-day	69	0	
6/22/2018 10:00	1278	719	559	clear-day	70	0	
6/22/2018 11:00	1985	1008	977	partly-cloudy-day	70	0	
6/22/2018 12:00	1892	899	993	partly-cloudy-day	74	0.0006	
6/22/2018 13:00	2063	902	1161	partly-cloudy-day	70	0	
6/22/2018 14:00	2038	877	1161	partly-cloudy-day	71	0	
6/22/2018 15:00	2135	1067	1068	partly-cloudy-day	71	0	
6/22/2018 16:00	2154	1071	1083	partly-cloudy-day	70	0	
6/22/2018 17:00	2202	1046	1156	partly-cloudy-day	69	0	
6/22/2018 18:00	1775	857	918	partly-cloudy-day	68	0	
6/22/2018 19:00	1371	657	714	partly-cloudy-day	68	0	
6/22/2018 20:00	834	440	394	partly-cloudy-day	67	0.0022	
6/22/2018 21:00	633	220	413	partly-cloudy-night	66	0	
6/22/2018 22:00	407	173	234	partly-cloudy-night	66	0	
6/22/2018 23:00	103	52	51	cloudy	66	0.0011	
6/23/2018 0:00	51	30	21	rain	64	0.0259	
6/23/2018 1:00	22	12	10	cloudy	63	0.0126	
6/23/2018 2:00	26	12	14	cloudy	63	0.0021	
6/23/2018 3:00	8	6	2	cloudy	63	0.0004	
6/23/2018 4:00	7	7	0	cloudy	63	0.0032	
6/23/2018 5:00	29	18	11	cloudy	63	0.0005	
6/23/2018 6:00	98	65	33	cloudy	63	0.0004	
6/23/2018 7:00	143	64	79	cloudy	64	0.0003	
6/23/2018 8:00	221	103	118	cloudy	64	0.0006	
6/23/2018 9:00	529	331	198	cloudy	64	0	
6/23/2018 10:00	1224	664	560	cloudy	64	0	
6/23/2018 11:00	1616	851	765	cloudy	64	0	
6/23/2018 12:00	1938	940	998	cloudy	64	0	
6/23/2018 13:00	2112	965	1147	cloudy	66	0.0026	
6/23/2018 14:00	2566	1176	1390	cloudy	64	0	
6/23/2018 15:00	2477	1026	1451	cloudy	65	0	
6/23/2018 16:00	2448	1096	1352	cloudy	66	0	
6/23/2018 17:00	2098	954	1144	cloudy	66	0	
6/23/2018 18:00	1680	772	908	cloudy	66	0	
6/23/2018 19:00	1493	714	779	cloudy	66	0	
6/23/2018 20:00	1017	439	578	cloudy	66	0	
6/23/2018 21:00	892	467	425	cloudy	65	0	
6/23/2018 22:00	477	216	261	cloudy	65	0	
6/23/2018 23:00	304	170	134	cloudy	65	0	
6/24/2018 0:00	176	105	71	cloudy	66	0	
6/24/2018 1:00	67	32	35	cloudy	66	0	
6/24/2018 2:00	35	15	20	cloudy	65	0	
6/24/2018 3:00	19	7	12	cloudy	65	0	
6/24/2018 4:00	34	18	16	cloudy	65	0	
6/24/2018 5:00	88	36	52	cloudy	65	0	
6/24/2018 6:00	81	37	44	cloudy	65	0.0005	
6/24/2018 7:00	151	74	77	cloudy	66	0	
6/24/2018 8:00	301	148	153	cloudy	67	0	
6/24/2018 9:00	812	453	359	cloudy	69	0	
6/24/2018 10:00	1295	739	556	cloudy	71	0	
6/24/2018 11:00	1966	1012	954	partly-cloudy-day	76	0	
6/24/2018 12:00	2222	1133	1089	partly-cloudy-day	79	0	
6/24/2018 13:00	2265	1085	1180	partly-cloudy-day	81	0	
6/24/2018 14:00	2386	1148	1238	partly-cloudy-day	79	0	
6/24/2018 15:00	2379	1070	1309	partly-cloudy-day	79	0.0243	
6/24/2018 16:00	2555	1109	1446	partly-cloudy-day	80	0.0178	
6/24/2018 17:00	2397	1061	1336	partly-cloudy-day	83	0.0214	
6/24/2018 18:00	1875	840	1035	partly-cloudy-day	83	0	
6/24/2018 19:00	1730	848	882	partly-cloudy-day	82	0.0015	
6/24/2018 20:00	1339	555	784	partly-cloudy-day	81	0.0038	
6/24/2018 21:00	721	199	522	partly-cloudy-night	79	0.0215	
6/24/2018 22:00	266	85	181	cloudy	72	0.0213	
6/24/2018 23:00	203	123	80	partly-cloudy-night	71	0.0035	
6/25/2018 0:00	75	36	39	partly-cloudy-night	70	0.0003	
6/25/2018 1:00	31	20	11	clear-night	70	0	
6/25/2018 2:00	3	1	2	clear-night	70	0	
6/25/2018 3:00	6	5	1	clear-night	70	0.0008	
6/25/2018 4:00	13	9	4	partly-cloudy-night	69	0	
6/25/2018 5:00	76	42	34	partly-cloudy-night	68	0.0002	
6/25/2018 6:00	142	65	77	partly-cloudy-day	67	0	
6/25/2018 7:00	270	126	144	clear-day	68	0	
6/25/2018 8:00	494	183	311	clear-day	70	0.0018	
6/25/2018 9:00	664	321	343	clear-day	71	0.0025	
6/25/2018 10:00	1175	613	562	partly-cloudy-day	73	0	
6/25/2018 11:00	1816	927	889	partly-cloudy-day	76	0	
6/25/2018 12:00	1825	788	1037	partly-cloudy-day	76	0	
6/25/2018 13:00	1972	886	1086	partly-cloudy-day	79	0	
6/25/2018 14:00	1963	874	1089	partly-cloudy-day	79	0	
6/25/2018 15:00	2072	943	1129	partly-cloudy-day	79	0	
6/25/2018 16:00	1925	931	994	partly-cloudy-day	80	0	
6/25/2018 17:00	1938	1093	845	clear-day	81	0	
6/25/2018 18:00	1812	1067	745	partly-cloudy-day	81	0	
6/25/2018 19:00	1655	971	684	clear-day	79	0	
6/25/2018 20:00	1299	580	719	clear-day	77	0	
6/25/2018 21:00	865	280	585	clear-night	74	0	
6/25/2018 22:00	493	188	305	clear-night	71	0	
6/25/2018 23:00	234	94	140	clear-night	70	0	
6/26/2018 0:00	75	32	43	clear-night	69	0	
6/26/2018 1:00	25	10	15	clear-night	68	0	
6/26/2018 2:00	12	11	1	clear-night	66	0	
6/26/2018 3:00	14	6	8	clear-night	63	0	
6/26/2018 4:00	4	1	3	clear-night	64	0	
6/26/2018 5:00	73	45	28	clear-night	63	0	
6/26/2018 6:00	233	104	129	clear-day	63	0	
6/26/2018 7:00	271	118	153	clear-day	64	0	
6/26/2018 8:00	535	174	361	clear-day	66	0	
6/26/2018 9:00	523	219	304	clear-day	68	0	
6/26/2018 10:00	1011	589	422	clear-day	71	0	
6/26/2018 11:00	1588	813	775	partly-cloudy-day	72	0	
6/26/2018 12:00	1860	975	885	partly-cloudy-day	72	0	
6/26/2018 13:00	1967	891	1076	clear-day	73	0	
6/26/2018 14:00	2029	796	1233	clear-day	74	0	
6/26/2018 15:00	1998	890	1108	clear-day	75	0	
6/26/2018 16:00	1932	988	944	clear-day	74	0	
6/26/2018 17:00	1981	1014	967	clear-day	74	0	
6/26/2018 18:00	1809	1068	741	partly-cloudy-day	74	0	
6/26/2018 19:00	1572	862	710	partly-cloudy-day	72	0	
6/26/2018 20:00	1287	624	663	partly-cloudy-day	71	0	
6/26/2018 21:00	821	280	541	clear-night	70	0	
6/26/2018 22:00	429	155	274	clear-night	69	0	
6/26/2018 23:00	192	111	81	clear-night	68	0	
6/27/2018 0:00	86	36	50	clear-night	67	0	
6/27/2018 1:00	39	28	11	clear-night	66	0	
6/27/2018 2:00	17	7	10	partly-cloudy-night	65	0	
6/27/2018 3:00	8	4	4	partly-cloudy-night	65	0	
6/27/2018 4:00	8	6	2	partly-cloudy-night	64	0	
6/27/2018 5:00	73	48	25	partly-cloudy-night	64	0	
6/27/2018 6:00	199	97	102	partly-cloudy-day	64	0	
6/27/2018 7:00	305	142	163	partly-cloudy-day	65	0	
6/27/2018 8:00	417	148	269	partly-cloudy-day	67	0	
6/27/2018 9:00	541	251	290	partly-cloudy-day	69	0	
6/27/2018 10:00	871	477	394	partly-cloudy-day	70	0	
6/27/2018 11:00	1292	690	602	cloudy	71	0	
6/27/2018 12:00	1505	670	835	cloudy	72	0	
6/27/2018 13:00	1616	753	863	cloudy	72	0	
6/27/2018 14:00	1912	893	1019	cloudy	72	0	
6/27/2018 15:00	1864	806	1058	cloudy	72	0	
6/27/2018 16:00	1750	804	946	cloudy	72	0	
6/27/2018 17:00	1859	949	910	cloudy	71	0	
6/27/2018 18:00	1531	789	742	cloudy	71	0	
6/27/2018 19:00	939	498	441	cloudy	70	0.0003	
6/27/2018 20:00	579	241	338	cloudy	70	0.0031	
6/27/2018 21:00	393	149	244	cloudy	70	0.003	
6/27/2018 22:00	145	63	82	cloudy	70	0.0031	
6/27/2018 23:00	130	92	38	cloudy	69	0.003	
6/28/2018 0:00	90	58	32	cloudy	70	0.001	
6/28/2018 1:00	23	12	11	cloudy	70	0.0009	
6/28/2018 2:00	8	4	4	cloudy	70	0.0003	
6/28/2018 3:00	6	4	2	cloudy	70	0.0145	
6/28/2018 4:00	2	0	2	rain	70	0.0467	
6/28/2018 5:00	18	10	8	rain	71	0.0592	
6/28/2018 6:00	39	14	25	rain	70	0.046	
6/28/2018 7:00	33	14	19	rain	70	0.0783	
6/28/2018 8:00	54	21	33	rain	70	0.0741	
6/28/2018 9:00	175	80	95	rain	71	0.0402	
6/28/2018 10:00	516	314	202	partly-cloudy-day	73	0.0052	
6/28/2018 11:00	872	469	403	partly-cloudy-day	76	0.001	
6/28/2018 12:00	1151	545	606	rain	78	0.0342	
6/28/2018 13:00	1402	541	861	partly-cloudy-day	81	0.0007	
6/28/2018 14:00	1117	483	634	partly-cloudy-day	81	0.0006	
6/28/2018 15:00	1396	686	710	partly-cloudy-day	79	0.0043	
6/28/2018 16:00	1446	657	789	rain	78	0.0282	
6/28/2018 17:00	1349	593	756	rain	81	0.0649	
6/28/2018 18:00	971	581	390	partly-cloudy-day	80	0.0165	
6/28/2018 19:00	935	515	420	partly-cloudy-day	78	0.0217	
6/28/2018 20:00	888	434	454	partly-cloudy-day	77	0.0072	
6/28/2018 21:00	689	319	370	partly-cloudy-night	75	0.0038	
6/28/2018 22:00	386	170	216	clear-night	74	0.0007	
6/28/2018 23:00	196	105	91	clear-night	74	0	
6/29/2018 0:00	93	45	48	clear-night	73	0.0002	
6/29/2018 1:00	39	17	22	clear-night	74	0	
6/29/2018 2:00	12	7	5	clear-night	73	0	
6/29/2018 3:00	10	4	6	clear-night	72	0	
6/29/2018 4:00	11	6	5	clear-night	71	0	
6/29/2018 5:00	56	33	23	clear-night	71	0	
6/29/2018 6:00	158	70	88	clear-day	71	0	
6/29/2018 7:00	247	111	136	clear-day	72	0	
6/29/2018 8:00	422	163	259	clear-day	74	0.0002	
6/29/2018 9:00	715	382	333	clear-day	76	0.0002	
6/29/2018 10:00	1229	697	532	clear-day	79	0	
6/29/2018 11:00	1733	849	884	clear-day	83	0.0002	
6/29/2018 12:00	1744	811	933	partly-cloudy-day	84	0.0039	
6/29/2018 13:00	1830	809	1021	partly-cloudy-day	86	0.0016	
6/29/2018 14:00	1887	944	943	clear-day	88	0	
6/29/2018 15:00	1971	879	1092	partly-cloudy-day	88	0	
6/29/2018 16:00	1705	869	836	clear-day	89	0	
6/29/2018 17:00	1547	828	719	clear-day	89	0	
6/29/2018 18:00	1635	851	784	clear-day	89	0	
6/29/2018 19:00	1428	855	573	clear-day	87	0	
6/29/2018 20:00	1516	731	785	clear-day	85	0.0002	
6/29/2018 21:00	1081	368	713	clear-night	83	0	
6/29/2018 22:00	637	318	319	clear-night	81	0	
6/29/2018 23:00	360	161	199	clear-night	80	0	
6/30/2018 0:00	150	76	74	clear-night	79	0	
6/30/2018 1:00	53	15	38	clear-night	77	0	
6/30/2018 2:00	52	29	23	clear-night	75	0	
6/30/2018 3:00	28	21	7	clear-night	74	0	
6/30/2018 4:00	11	5	6	clear-night	73	0	
6/30/2018 5:00	63	44	19	clear-night	71	0	
6/30/2018 6:00	151	81	70	clear-day	71	0	
6/30/2018 7:00	241	103	138	clear-day	73	0	
6/30/2018 8:00	451	270	181	clear-day	76	0	
6/30/2018 9:00	821	478	343	clear-day	80	0	
6/30/2018 10:00	1532	969	563	clear-day	84	0	
6/30/2018 11:00	3830	3657	173	clear-day	86	0	
6/30/2018 12:00	3445	3307	138	clear-day	87	0	
6/30/2018 13:00	2404	2071	333	clear-day	89	0	
6/30/2018 14:00	2091	1106	985	clear-day	90	0	
6/30/2018 15:00	2395	942	1453	clear-day	91	0	
6/30/2018 16:00	2170	1018	1152	clear-day	91	0	
6/30/2018 17:00	2047	916	1131	clear-day	90	0	
6/30/2018 18:00	2054	1027	1027	clear-day	91	0	
6/30/2018 19:00	1935	959	976	clear-day	89	0	
6/30/2018 20:00	2020	904	1116	clear-day	87	0	
6/30/2018 21:00	1331	445	886	clear-night	83	0	
6/30/2018 22:00	705	244	461	clear-night	81	0	
6/30/2018 23:00	535	265	270	clear-night	80	0	
7/1/2018 0:00	179	87	92	clear-night	80	0	
7/1/2018 1:00	82	33	49	clear-night	78	0	
7/1/2018 2:00	30	22	8	clear-night	77	0	
7/1/2018 3:00	39	16	23	clear-night	77	0	
7/1/2018 4:00	17	13	4	clear-night	76	0	
7/1/2018 5:00	50	31	19	clear-night	76	0	
7/1/2018 6:00	95	41	54	clear-day	75	0	
7/1/2018 7:00	246	158	88	clear-day	78	0	
7/1/2018 8:00	445	260	185	clear-day	79	0	
7/1/2018 9:00	972	581	391	partly-cloudy-day	83	0	
7/1/2018 10:00	1213	637	576	clear-day	84	0	
7/1/2018 11:00	983	503	480	clear-day	89	0	
7/1/2018 12:00	1154	676	478	clear-day	91	0	
7/1/2018 13:00	1354	693	661	clear-day	92	0	
7/1/2018 14:00	1638	765	873	clear-day	94	0	
7/1/2018 15:00	1669	818	851	clear-day	93	0.0002	
7/1/2018 16:00	1683	823	860	clear-day	92	0	
7/1/2018 17:00	1495	662	833	clear-day	92	0	
7/1/2018 18:00	1486	707	779	clear-day	92	0	
7/1/2018 19:00	1547	850	697	clear-day	90	0	
7/1/2018 20:00	1568	661	907	clear-day	88	0	
7/1/2018 21:00	1019	320	699	clear-night	85	0	
7/1/2018 22:00	604	222	382	clear-night	84	0	
7/1/2018 23:00	285	89	196	clear-night	83	0	
